music:default1
message:The cube you see in front of you is VERY important in this test chamber.
message1:If anything should happen to it, I suggest you reassemble it.
NNNNNNNNNNNNNNNNNNNNNNNNNNNNNNNNNNNNNNNNNNNNNNNNNNNNNNNNNNNNNNNNNNNNNNNNNNNNNNNNNNNNNNNN
NNNNNNNNNNNNNNNNNNNNNNNNNNNNNN#                    NNNNNNNNNNNNNNNNNNNNNNNNNNNNNNNNNNNNN
NNNNNNNNNNNNNNNNNNNNNNNNNNNNNN#                    NNNNNNNNNNNNNNNNNNNNNNNNNNNNNNNNNNNNN
NNNNNNNNNNNNNNNNNNNNNNNNNNNNNNN    NNNNNNNN    NNNJNNNNNNNNNNNNNNNNNNNNNNNNNNNNNNNNNNNNN
NNNNNNNNNNNNNNNNNNNNNNNNNNNNNNN    NNNNNNNNN   NNNNNNNNNNNNNNNNNNNNNNNNNNNNNNNNNNNNNNNNN
NNNNNNNNNNNNNNNNNNNNNNNNNNNNNNN    NNNNNNNNNNNNNNNNNNNNNNNNNNNNNNNNNNNNNNNNNNNNNNNNNNNNN
NNNNNNNNNNNNNNNNNNNNNNNNNNNNNNN               #NNNNNNNNNNNNNNNNNNNNNNNNNNNNNNNNNNNNNNNNN
NNNNNNNNNNNNNNNNNNNNNNNNNNNNNNN               #NNNNNNNNNNNNNNNNNNNNNNNNNNNNNNNNNNNNNNNNN
NNNNNNNNNNNNNNNNNNNNNNNNNNNNNNNNNNNNNNNNNN    NNNNNNNNNNNNNNNNNNNNNNNNNNNNNNNNNNNNNNNNNN
NNNNNNNNNNNNNNNNNNNNNNNNNNNNNNNNNNNNNNNNNN    NNNNNNNNNNNNNNNNNNNNNNNNNNNNNNNNNNNNNNNNNN
NNNNNNNNNNNNNNNNNNNNNNNNNNNNNNNNNNNNNNNNNN    NNNNNNNNNNNNNNNNNNNNNNNNNNNNNNNNNNNNNNNNNN
NNNNNNNNNNNNNNNNNNNNNNNNNNNNNN#    "          #NNNNNNNNNNNNNNNNNNNNNNNNNNNNNNNNNNNNNNNNN
NNNNNNNNNNNNNNNNNNNNNNNNNNNNNN#    "          #NNNNNNNNNNNNNNNNNNNNNNNNNNNNNNNNNNNNNNNNN
NNNNNNNNNNNNNNNNNNNNNNNNNNNNNNN    NNNNNNNNNNNNNNNNNNNNNNNNNNNNNNNNNNNNNNNNNNNNNNNNNNNNNNNN               NNNNNN$NNNNNN#     
NNNNNNNNNNNNNNNNNNNNNNNNNNNNNNN    NNNNNNNNNNNNNNNNNNNNNNNNNNNNNNNNNNNNNNNNNNNNNNNNNNNNNNNN               NNNNNN$NNNNNN#     
NNNNNNNNNNNNNNNNNNNNNNNNNNNNNNN    NN###NNNNNNNNNNNNNNNNNNNNNNNNNNNNNNNNNNNNNNNNNNNNNNNNNNN               NNNN     NNNN#     
NNNNNNNNNNNNNNNNNNNNNNNNNNNNNNN               NNNNNNNNNNNNNNNNNNNNNNNNNNNNNNNNNNNNNNNNNNNNN               NNNN     NNNNN     
NNNNNNNNNNNNNNNNNNNNNNNNNNNNNNN               NNNNNNNNNNNNNNNNNNNNNNNNNNNNNNNNNNNNNNNNNNNNN               NNNN               
NNNNNNNNNNNNNNNNNNNNNNNNNNNNNNNNNNNNN         NNNNNNNNNNNNNNNNNNNNNNNNNNNNNNNNNNNNNNNNNNNNN               NNNN               
NNNNNNNNNNNNNNNNNNNNNNNNNNNNNNNNNNNNNNN       NNNNNNNNNNNNNNNNNNNNNNNNNNNNNNNNNNNNNNNNNNNNN               NNNN     NNNNNNNNNN
NNNNNNNNNNNNNNNNNNNNNNNNNNNNNNNNNNNNNNNNN     NNNNNNNNNNNNNNNNNNNNNNNNNNNNNNNNNNNNNNNNNNNNN               NNNN     NN#####NNN
NNNNNNNNNNNNNNNNNNNNNNNNNNNNNN#               NNNNNNNNNNNNNNNNNNNNNNNNNNNNNNNNNNNNNNNNNNNNN               NNNN     NN#    NNN
NNNNNNNNNNNNNNNNNNNNNNNNNNNNNN#               NNNNNNNNNNNNNNNNNNNNNNNNNNNNNNNNNNNNNNNNNNNN#               NNNN     NN#    NNN
NNNNNNNNNNNNNNNNNNNNNNNNNNNNNNN    NNNNNNNNNNNNNNNNNNNNNNNNNNNNNNNNNNNNNNNNNNNNNNNNNNNNNNN#               NNNN     NNNG$$$NNN
NNNNNNNNNNNNNNNNNNNNNNNNNNNNNNN    NNNNNNNNNNNNNNNNNNNNNNNNNNNNNNNNNNNNNNNNNNNNNNNNNNNNNNN#               NNNN     NNNN   NNN
NNNNNNNNNNNNNNNNNNNNNNNNNNNNNNN    NNNNNNNNNNNNNNNNNNNNNNNNNNNNNNNNNNNNNNNNNNNNNNNNNNNNNNNN               NNNN     NNNN   NNN
NNNNNNNNNNNNNNNNNNNNNNNNNNNNNN#               #NNNNNNNNNNNNNNNNNNNNNNNNNNNNNNNNNNNNNNNNNNNN               NNNN     NNNN   NNN
NNNNNNNNNNNNNNNNNNNNNNNNNNNNNN#               #NNNNNNNNNNNNNNNNNNNNNNNNNNNNNNNNNNNNNNNNNNNN               NNNN     NNNN   NNN
NNNNNNNNNNNNNNNNNNNNNNNNNNNNNNNNNNNNNNNNNN    NNNNNNNNNNNNNNNNNNNNNNNNNNNNNNNNNNNNNNNNNNNNN               NNNN     NNNN   NNN
NNNNNNNNNNNNNNNNNNNNNNNNNNNNNNNNNNNNNNNNNN    NNNNNNNNNNNNNNNNNNNNNNNNNNNNNNNNNNNNNNNNNNNNN               NNNN     NNNN   NNN
NNNNNNNNNNNNNNNNNNNNNNNNNNNNNNNNNNNNNNNNNN    NNNNNNNNNNNNNNNNNNNNNNNNNNNNNNNNNNNNNNNNNNNNN          #####NNNN     NNNN   NNN
NNNNNNNNNNNNNNNNNNNNNNN#      % a   %    1    j                                   %     %              N  NNNN     NNNN   NNN
NNNNNNNNNNNNNNNNNNNNNNN#      % a @ %  & 1    j                                   %   Q %              N  NNNN     NNNN   NNN
NNNNNNNNNNNNNNNNNNNNNNN#    #NNNNNNNNNNNNN    NNNNNNNNNNNNNNNNNNNNNNNNNNNNNNNNNNNNNNNNNNNNN##########  N  NNNN     NNNN   NNN
NNNNNNNNNNNNNNNNNNNNNNN#    #NN###NN#####N    NNNNNNNNNNNNNNNNNNNNNNNNNNNNNNNNNNNNNNNNNNNNNNNNNNNNNNNNNNNNNNNN     NNNN   NNN
NNNNNNNNNNNNNNNNNNNNNNN#    #N##N##NNNN##N    NNNNNNNNNNNNNNNNNNNNNNNNNNNNNNNNNNNNNNNNN###NNN###NNNNNNNNNNNNNN     NNNN   NNN
NNNNNNNNNNNNNNNNNNNNNNN#    #N##N##NNN##NN    NNNNNNNNNNNNNNNNNNNNNNNNNNNNNNNNNNNNNNNN##N##N##N##NNNNNNNNNNNNN     NNN#      
NNNNNNNNNNNNNNNNNNNNNNN#    #N##N##NN##NNN    NNNNNNNNNNNNNNNNNNNNNNNNNNNNNNNNNNNNNNNN##N##NN###NNNNNNNNNNNNNN#####NNN#      
NNNNNNNNNNNNNNNNNNNNNNN#    #NN###NNN##NNN++++NNNNNNNNNNNNNNNNNNNNNNNNNNNNNNNNNNNNNNNN##N##N##N##NNNNNNNNNNNNNNNNNNNNNNNNNNNN
NNNNNNNNNNNNNNNNNNNNNNN#    #NNNNNNNNNNNNN    NNNNNNNNNNNNNNNNNNNNNNNNNNNNNNNNNNNNNNNNN###NNN###NNNNNNNNNNNNNNNNNNNNNNNNNNNNN
NNNNNNNNNNNNNNNNNNNNNNN#    #NNNNNNNNNNNNN    NNNNNNNNNNNNNNNNNNNNNNNNNNNNNNNNNNNNNNNNNNNNNNNNNNNNNNNNNNNNNNNNNNNNNNNNNNNNNNN
NNNNNNNNNNNNNNNNNNNNNNN#    #NNNNNNNNNNNNN    NNNNNNNNNNNNNNNNNNNNNNNNNNNNNNNNNNNNNNNNNN
NNNNNNNNNNNNNNNNNNNNNNN#    #NNNNNNNNNNNNN    NNNNNNNNNNNNNNNNNNNNNNNNNNNNNNNNNNNNNNNNNN
NNNNNNNNNNNNNNNNNNNNNNN#    #NNNNNNNNNNNNN    NNNNNNNNNNNNNNNNNNNNNNNNNNNNNNNNNNNNNNNNNN
NNNNNNNNNNNNNNNNNNNNNNN#    #NNNNNNNNNNNNN    NNNNNNNNNNNNNNNNNNNNNNNNNNNNNNNNNNNNNNNNNN
NNNNNNNNNNNNNNNNNNNNNNN#    #NNNNNNNNNNNNN    NNNNNNNNNNNNNNNNNNNNNNNNNNNNNNNNNNNNNNNNNN
NNNNNNNNNNNNNNNNNNNNNNN#    #NNNNNNNNNNNNN    NNNNNNNNNNNNNNNNNNNNNNNNNNNNNNNNNNNNNNNNNN
NNNNNNNNNNNNNNNNNNNNNNN#    #NNNNNNNNNNNNN####NNNNNNNNNNNNNNNNNNNNNNNNNNNNNNNNNNNNNNNNNN
NNNNNNNN####NNNNNNNNNNN#    #
NNNNNNNN#                   #
NNNNNNNN#                   #
NNNNNNNNN NNNNNNNNNNNNNNNNNNN
######NNN NNNNN
#     NNN NNN##
#     $$$ $$$ #
#     NNN NNN$N
#$$$$NNNN NNN$N
#         NNN$N
#        &NNN$N
#    ####INNN$N
#    #NNNNNNN$N
#    # $$$$$$ #
NbbbbN$NNNNNN##
name:Be careful, and take a cube.
