music:default
message:Welcome to the final test.  Upon completion of the test, please jump down the victory hatch for your cake.
NNNNNNNNNNNNNNNNNNNNNNNNNNNNNNNNNNNNNNNNNNNNNNNNNNNNNNNNNNNNNNNNNNNNN
NNNNNNNNNNNNNNNNNNNNNNNNNNNNNNNNNNNNNNNNNNNNNNNNNNNNNNNNNNNNNNNNNNNNN
NNNNNNNNNNNNNNNNNNNNNNNNNNNNNNNNNNNNNNNNNNNNNNNNNNNNNNNNNNNNNNNNNNNNN
NNNNNNNNNNNNNNNNNNNNNNNNNNNNNN                N              NNNNNNNN
NNNNNNNNNNNNNNNNNNNNNNNNNNNNNN                Ncc            NNNNNNNN
NNNNNNNNNNNNNNNNNNNNNNNNNNNNNN    NNN###  NNNBN+NNNNNNNNN    NNNNNNNN
NNNNNNNNNNNNNNNNNNNNNNNNNNNNNN    NNNNNN  NNNNN+NNNNNNNNN    NNNNNNNN
NNNNNNNNNNNNNNNNNNNNNNNNNNNNNN       +$OO OOO$ +       #N    NNNNNNNN
NNNNNNNNNNNNNNNNNNNNNNNNNNNNNN    NNN+$OOOOOO$ +       #N    NNNNNNNN
NNNNNNNNNNNNNNNNNNNNNNNNNNNNNN    NNN+$OOOOOO$ +       #N    NNNNNNNN
NNNNNNNNNNNNNNNNNNNNNNNNNNNNNN    NNN+$OOOOOO$    $    #N    NNNNNNNN
NNNNNNNNNNNNNNNNNNNNNNNNNNNNNN    NNN+bOOOOOO$    $    #N    NNNNNNNN
NNNNNNNNNNNNNNNNNNNNNNNNNNNNNN    NNN+$$$$$$$$CCCC$    #N    NNNNNNNN
NNNNNNNNNNNNNNNNNNNNNNNNNNNNNN    NNN+$                #N    NNNNNNNN
NNNNNNNNNNNNNNNNNNNNNNNNNNNNNN    NNN+$                #N    NNNNNNNN
NNNNNNNNNNNNNNNNNNNNNNNNNNNNNN    NNN+$                #N    NNNNNNNN
NNNNNNNNNNNNNNNNNNNNNNNNNNNNNN    NNN+$                # &    NNNNNNN
NNNNNNNNNNNNNNNNNNNNNNNNNNNNNN####NNN+$                #DNNNNDNNNNNNN
NNNNNNNNNNNNNNNNNNNNNNNNNNNNNNNNNNNNN+$                #NNNNNNNNNNNNN
NNNNNNNNNNNNNNNNNNNNNNNNNNNNNNNNNNNNN+$                #NNNNNNNNNNNNN
NNNNNNNNNNNNNNNNNNNNNNNNNNNNNNNNNNNNN+$                #NNNNNNNNNNNNN
NNNNNNNNNNNNNNNNNNNNNNNNNNNNNNNNNNNNN+$                #NNNNNNNNNNNNN
N              NN       % a   %                        d%%          N
N              NN       % a @ % N                      d%%          N
N    NNNNNN    NN    NNNNNNNNNNNN#######################NNNNNNNNNNN N
N    NNNNNN    #N    NNNNNNNNNNNNNNNNNNNNNNNNNNNNNNNNNNNNNNNNNNNNNN N
N        NN    #N    NNNNNNNN##NNN###NNNNNNNNNNNNNNNNNNNNNNNNNNNNNN N
N        NN$$$$NN    NNNNNNN###NN##N##NNNNNNNNNNNNNNNNNNNNNNNNNNNNN N
N        NN    NN    NNNNNNNN##NN##N##NNNNNNNNNNNNNNNNNNNNNNNNNNNNN N
N        NN    NN    NNNNNNNN##NN##N##NNNNNNNNNNNNNNNNNNNNNNNNNNNNN N
N        NN    NN    NNNNNNN####NN###NNNNNNNNNNNNNNNNNNNNNNNNNNNNNN N
N        NN    NN    NNNNNNNNNNNNNNNNNNNNNNNNNNNNNNNNNNNNNNNNNNNNNN N
N        NN    NN    NNNNNNNNNNNNNNNNNNNNNNNNNNNNNNNNNNNNNNNNNNNNNN N
N        NN    NN  ##NNNNNNNNNNNNNNNNNNNNNNNNNNNNNNNNNNNNNNNNNNNNNN N
N        NN    NN  NNNNNNNNNNNNNNNNNNNNNNNNNNNNNNNNNNNNNNNNNNNNNNNN N
N        NN    NN    NNNNNNNNNNNNNNNNNNNNNNNNNNNNNNNNNNNNNNNNNNNNNN N
N        NN    NN    NNNNNNNNNNNNNNNNNNNNNNNNNNNNNNNNNNNNNNNNNNNNNN N
#        NN    NN    NNNNNNNNNNNNNNNNNNNNNNNNNNNNNNNNNNNNNNNNNNNNNN N
#        NN    NN##  NNNNNNNNNNNNNNNNNNNNNNNNNNNNNNNNNNNNNNNNNNNNNN N
N    ####NN    NNNN  NNNNNNNNNNNNNNNNNNNNNNNNNNNNNNNNNNNNNNNNNNNNNN N
N    ####NN    NN    NNNNNNNNNNNNNNNNNNNNNNNNNNNNNNNNNNNNNNNNNNNNNN N
         NN    NN    NNNNNNNNNNNNNNNNNNNNNNNNNNNNNNNNNNNNNNNNNNNNNN N
         NN    NN    NNNNNNNNNNNNNNNNNNNNNNNNNNNNNNNNNNNNNNNNNNNNNN N
N    NNNNNN    NN  ##NNNNNNNNNNNNNNNNNNNNNNNNNNNNNNNNNNNNNNNNNNNNNN N
NNNNNNNNNNNNNNNNNNNNNNNNNNNNNNNNNNNNNNNNNNNNNNNNNNNNNNNNNNNNNNNNNNN N
NNNNNNNNNNNNNNNNNNNNNNNNNNNNNNNNNNNNNNNNNNNNNNNNNNNNNNNNNNNNNNNNNNN N
NNNNNNNNNNNNNNNNNNNNNNNNNNNNNNNNNNNNNNNNNNNNNNNNNNNNNNNNNNNNNNNNNNN N
NNNNNNNNNNNNNNNNNNNNNNNNNNNNNNNNNNNNNNNNNNNNNNNNNNNNNNNNNNNNNNNNNNN N
NNNNNNNNNNNNNNNNNNNNNNNNNNNNNNNNNNNNNNNNNNNNNNNNNNNNNNNNNNNNNNNNNNN N
NNNNNNNNNNNNNNNNNNNNNNNNNNNNNNNNNNNNNNNNNNNNNNNNNNNNNNNNNNNNNNNNNNN N
NNNNNNNNNNNNNNNNNNNNNNNNNNNNNNNNNNNNNNNNNNNNNNNNNNNNNNNNNNNNNNNNNNN N
NNNNNNNNNNNNNNNNNNNNNNNNNNNNNNNNNNNNNNNNNNNNNNNNNNNNNNNNNNNNNNNNNNN N
NNNNNNNNNNNNNNNNNNNNNNNNNNNNNNNNNNNNNNNNNNNNNNNNNNNNNNNNNNNNNNNNNNNQN
NNNNNNNNNNNNNNNNNNNNNNNNNNNNNNNNNNNNNNNNNNNNNNNNNNNNNNNNNNNNNNNNNNN N
NNNNNNNNNNNNNNNNNNNNNNNNNNNNNNNNNNNNNNNNNNNNNNNNNNNNNNNNNNNNNNNNNNN N
NNNNNNNNNNNNNNNNNNNNNNNNNNNNNNNNNNNNNNNNNNNNNNNNNNNNNNNNNNNNNNNNNNN N
NNNNNNNNNNNNNNNNNNNNNNNNNNNNNNNNNNNNNNNNNNNNNNNNNNNNNNNNNNNNNNNNNNN N
NNNNNNNNNNNNNNNNNNNNNNNNNNNNNNNNNNNNNNNNNNNNNNNNNNNNNNNNNNNNNNNNNNN N
NNNNNNNNNNNNNNNNNNNNNNNNNNNNNNNNNNNNNNNNNNNNNNNNNNNNNNNNNNNNNNNNNNN N
NNNNNNNNNNNNNNNNNNNNNNNNNNNNNNNNNNNNNNNNNNNNNNNNNNNNNNNNNNNNNNNNNNN N
NNNNNNNNNNNNNNNNNNNNNNNNNNNNNNNNNNNNNNNNNNNNNNNNNNNNNNNNNNNNNNNNNNN N
NNNNNNNNNNNNNNNNNNNNNNNNNNNNNNNNNNNNNNNNNNNNNNNNNNNNNNNNNNNNNNNNNNN N
NNNNNNNNNNNNNNNNNNNNNNNNNNNNNNNNNNNNNNNNNNNNNNNNNNNNNNNNNNNNNNNNNNN N
NNNNNNNNNNNNNNNNNNNNNNNNNNNNNNNNNNNNNNNNNNNNNNNNNNNNNNNNNNNNNNNNNNN N
NNNNNNNNNNNNNNNNNNNNNNNNNNNNNNNNNNNNNNNNNNNNNNNNNNNNNNNNNNNNNNNNNNN N
NNNNNNNNNNNNNNNNNNNNNNNNNNNNNNNNNNNNNNNNNNNNNNNNNNNNNNNNNNNNNNNNNNN N
NNNNNNNNNNNNNNNNNNNNNNNNNNNNNNNNNNNNNNNNNNNNNNNNNNNNNNNNNNNNNNNNNNN N
NNNNNNNNNNNNNNNNNNNNNNNNNNNNNNNNNNNNNNNNNNNNNNNNNNNNNNNNNNNNNNNNNNN N
NNNNNNNNNNNNNNNNNNNNNNNNNNNNNNNNNNNNNNNNNNNNNNNNNNNNNNNNNNNNNNNNNNN N
NNNNNNNNNNNNNNNNNNNNNNNNNNNNNNNNNNNNNNNNNNNNNNNNNNNNNNNNNNNNNNNNNNN N
NNNNNNNNNNNNNNNNNNNNNNNNNNNNNNNNNNNNNNNNNNNNNNNNNNNNNNNNNNNNNNNNNNN N
NNNNNNNNNNNNNNNNNNNNNNNNNNNNNNNNNNNNNNNNNNNNNNNNNNNNNNNNNNNNNNNNNNN N
name:The final test
