message:Hi there!  Press any key to start...
######    ###   ###### ######    ###    #####  ##  ##
##   ##  ## ##    ##   ##   ##  ## ##  ##   ## ## ## 
######  #######   ##   ######  ####### ##      ####  
##  ##@ ##   ##   ##   ##      ##   ## ##   ## ## ## 
##   ## ##   ##   ##   ##      ##   ##  #####  ##  ##

                  #####      ##### 
                 ##   ##    ##  ###
                    ###     ## # ##
                  ###Q      ###  ##
                 ####### ##  ##### 
