name:FILO
NN>h            N  N
NNNNNNNNNNNNNNNAN  N
NNNNNNNNNNNN       N
NNNNNNNNNNNNHN&NN++N
NNNNNNNNNNNNNN&NN +N
NNNNNNNNNNNNNN&NN +N
NNNNNNNNNNN#NN&NN +N
NNNNNNN Q i NNaNN +
NNNNNNNNNNN$NN NN +
NNNNNNNNNNN$NN NN +
NNNNNNNNNNN NN NN +
NNNNNNNNNNN NN NN +
N#      +   $$ $$ +
NN  IIII NN+NN NN +
NN        N"NN NN +
NN        N"NN NN +
NN        N"NN NN +
NN        NNNN NN +
NN        NNNN NN +
NN        NNNN NN +
NN        NNNN NN +
NN         NNN NN +
NN             @  +
NNNNNNNNNNN$NN#NN#N
NNNNNNNNNNNNNNNNNNNN
