name:You vs. Gravity (I)
NNNNNNNNNNNNNNNNNNNNN#NNNNNNNN
NNNNNNNNNNNNNNNNN Q jhhNNNNNNN
NNNNNNNNNNNNNNNNNNNNNNN$$NNNNN
NNNN&NNN#N#NNNNNNNNNN      NNN
NNNN=NNN   NNNNNNNNN        NN
NNNNiNNN   NNNNNNNNN        NN
NNN                N        NN
NN#      @         $        #N
NNNNjNNN#N#NNN+NNNNN  J  H  NN
NNNN#NNNNNNN  +NNNNN  N  N  NN
NNNNNNNNNNNNINNNNNNN""""""""NN
NNNNNNNNNNNNNNNNNNNNNNNNNNNNNN

