name:You vs. Gravity (II)
NNNNNNNNN&NNNNNNNNNNN% %NNNNNN
NNNNNNNNNeNNNNNNNNNNN% %N#NNNN
NNNN#NNNN&NNNNNNNNNNN% %N N&NN
NNNN      NNNNNNNNNNN% %NiNdNNNNN
NNNN (((((NN#l$$             NO#N
NNNNiNNNNNNNN NNN N $$k$$$NkNN$NN
NNNN NNNNNNNN N&NLNLNN      N$N
NNNN NNNNN Q  N     j       $N
NNNN NNNNNNNNNN)))))))      NN
NNNN NNNNNNNNNNNNNNNNN      NN
NNN# @             j        #N
NNNN+++N+NNN+NNNNNNN+++++HNNNN
NNNN   NINN + NNNNNN        NN
NNNN#NNNNNN+NJNNNNNN"###""""NN
NNNNNNNNN j+NNNNNNNNNNNNNNNNNN
NNNNNNNNNENNNNNNNNNNNNNNNNNNNN
N
N
N
N
N
N
N
N
N
N
N
N
N
N
N
N
N
N
N
N
N
N
N
N
h
K
