music:default2
name:Elementary number theory
message1:Good things come to those who wait... sometimes.
NNNNb>NNNNNNNNNNNNNNNNNNNNNNNNNNNNNNNNNNNNNNNNNNNNNNNNNNNNNNNNNNNNNNNNNNNNNNNNNNNN
NNNN NNNNNNNNNNNNNNNNNNNNNNNNNNNNNNNNNNNNNNNNNNNNNNNNNNNNNNNNNNNNNNNNNNNNNNNNNNNNN
NN                              NNNNNNNNNNNNNNNNNNNNNNNNNNNNNNNNNNNNNNNNNNNNNNNNNN
NN=NNNNNNNNNNNNNNNNNNNNNNNNNNNNNNNNNNNNNNNNNNNNNNNNNNNNNNNNNNNNNNNNNNNNNNNNNNNNNNN
N" NNNNNNNNNNNNNNNNNNNNNNNNNNNNNNNNNNNNNNNNNNNNNNNNNNNNNNNNNNNNNNNNNNNNNNNNNNNNNNN
NNAN                                     @                                      NN
NN$NNNNNNNNN$NNNNNNNNN$NNNNNNNNN$NNNNNNNNN$NNNNNNNNN$NNNNNNNNN$NNNNNNNNN$NNNNNN NN
NN$NNNN$NNNN$NNNN$NNNN$NNNN$NNNN$NNNN$NNNN$NNNN$NNNN$NNNN$NNNN$NNNN$NNNN$NNNN$N NN
NN$N""%"%"%%%"%"%%%"%"%%%"%%%%%"%"%%%%%"%%%"%"%%%"%%%%%"%%%%%"%"%%%%%"%%%"%"%%% NN
NNb>NN                                                                        &  N
NN NNN=========================================================================N N
NN                                                                             N N
NN=####(#(###(#(###(#(###(#####(#(#####(###(#(###(#####(#####(#(#####(###(#(###N1N
N" N                                                                             N
NNAN NNNNNNNNNNNNNNNNNNNNNNNNNNNNNNNNNNNNNNNNNNNNNNNNNNNNNNNNNNNNNNNNNNNNNNNNNNNBN
NNNN NNNNNNNNNNNNNNNNNNNNNNNNNNNNNNNNNNNNNNNNNNNNNNNNNNNNNNNNNNNNNNNNNNNNNNNNNNNNN
NQa  NNNNNNNNNNNNNNNNNNNNNNNNNNNNNNNNNNNNNNNNNNNNNNNNNNNNNNNNNNNNNNNNNNNNNNNNNNNNN
NNNNNNNNNNNNNNNNNNNNNNNNNNNNNNNNNNNNNNNNNNNNNNNNNNNNNNNNNNNNNNNNNNNNNNNNNNNNNNNNNN
