music:default3
name:Emergence
message:The test environment seems to be evolving a collective sentience.
message1:So far, there are 8 identical units.
message2:They say that they need to get to "Vertiform City", whatever that is.
  N% a>Na
+ANNBNNNJNNNNNNNNNNNNNNNNNNNNNN
+N  b<<<<b                    N
+NGNNNNNNNNNNNNNNNNNNNNNNNNNNNN
+NNNNN<NNN>>>>>>>NNNNNN<NNN>>>>>>>NNNNNN<NNN>>>>>>>NNNNNN<NNN>>>>>>>NNNNNN<NNN>>>>>>>NNNNNN<NNN>>>>>>>NNNNNN<NNN>>>>>>>NNNNNN<NNN>>>>>>>NNNNNN
+NNNNN=NNN=======NNNNNN=NNN=======NNNNNN=NNN=======NNNNNN=NNN=======NNNNNN=NNN=======NNNNNN=NNN=======NNNNNN=NNN=======NNNNNN=NNN=======NNNNNN
+NNNNNgNNNgggggggNNNNNNgNNNgggggggNNNNNNgNNNgggggggNNNNNNgNNNgggggggNNNNNNgNNNgggggggNNNNNNgNNNgggggggNNNNNNgNNNgggggggNNNNNNgNNNgggggggNNNNNN
+NNN   NNN          N   NNN          N   NNN          N   NNN          N   NNN          N   NNN          N   NNN          N   NNN          NNN
+NNN NNNN<&&&&&&&NN N NNNN<&&&&&&&NN N NNNN<&&&&&&&NN N NNNN<&&&&&&&NN N NNNN<&&&&&&&NN N NNNN<&&&&&&&NN N NNNN<&&&&&&&NN N NNNN<&&&&&&&NN NNN
+NNN  NNN========NN N  NNN========NN N  NNN========NN N  NNN========NN N  NNN========NN N  NNN========NN N  NNN========NN N  NNN========NN NNN
+NNNN NNNggggggggNN NN NNNggggggggNN NN NNNggggggggNN NN NNNggggggggNN NN NNNggggggggNN NN NNNggggggggNN NN NNNggggggggNN NN NNNggggggggNN NNN
+NNNN NN         N  NN NN         N  NN NN         N  NN NN         N  NN NN         N  NN NN         N  NN NN         N  NN NN         N  NNN
+NNNN NN ((((((((N NNN NN ((((((((N NNN NN ((((((((N NNN NN ((((((((N NNN NN ((((((((N NNN NN ((((((((N NNN NN ((((((((N NNN NN ((((((((N NNNN
+NNNN N%           %NN N%           %NN N%           %NN N%           %NN N%           %NN N%           %NN N%           %NN N%           %NNN
+NNNN NN&gNNNNNNNNNNNN NN&gNNNNNNNNNNNN NN&gNNNNNNNNNNNN NN&gNNNNNNNNNNNN NN&gNNNNNNNNNNNN NN&gNNNNNNNNNNNN NN&gNNNNNNNNNNNN NN&gNNNNNNNNNNNNN
+NNNN NN& NNNNNNNNNNNN NN& NNNNNNNNNNNN NN& NNNNNNNNNNNN NN& NNNNNNNNNNNN NN& NNNNNNNNNNNN NN& NNNNNNNNNNNN NN& NNNNNNNNNNNN NN& NNNNNNNNNNNNN
+NNNN NN& NNNNNNNNNNNN NN& NNNNNNNNNNNN NN& NNNNNNNNNNNN NN& NNNNNNNNNNNN NN& NNNNNNNNNNNN NN& NNNNNNNNNNNN NN& NNNNNNNNNNNN NN& NNNNNNNNNNNNN
+NNNN N%& NNNNNNNNNNNN N%& NNNNNNNNNNNN N%& NNNNNNNNNNNN N%& NNNNNNNNNNNN N%& NNNNNNNNNNNN N%& NNNNNNNNNNNN N%& NNNNNNNNNNNN N%& NNNNNNNNNNNNN
+NNNN NN& NNNNNNNNNNNN NN& NNNNNNNNNNNN NN& NNNNNNNNNNNN NN& NNNNNNNNNNNN NN& NNNNNNNNNNNN NN& NNNNNNNNNNNN NN& NNNNNNNNNNNN NN& NNNNNNNNNNNNN
+NNNN NN& NNNNNNNNNNNN NN& NNNNNNNNNNNN NN& NNNNNNNNNNNN NN& NNNNNNNNNNNN NN& NNNNNNNNNNNN NN& NNNNNNNNNNNN NN& NNNNNNNNNNNN NN& NNNNNNNNNNNNN
+NNNN N%&      NNNNNNN N%&      NNNNNNN N%&      NNNNNNN N%&      NNNNNNN N%&      NNNNNNN N%&      NNNNNNN N%&      NNNNNNN N%&      NNNNNNNN
+NNNN NN&N=N=N NNNNNNN NN&N=N=N NNNNNNN NN&N=N=N NNNNNNN NN&N=N=N NNNNNNN NN&N=N=N NNNNNNN NN&N=N=N NNNNNNN NN&N=N=N NNNNNNN NN&N=N=N NNNNNNNN
+NNNN NN&  N N NNNNNNN NN&  N N NNNNNNN NN&  N N NNNNNNN NN&  N N NNNNNNN NN&  N N NNNNNNN NN&  N N NNNNNNN NN&  N N NNNNNNN NN&  N N NNNNNNNN
+NNNN NN& NN N NNNNNNN NN& NN N NNNNNNN NN& NN N NNNNNNN NN& NN N NNNNNNN NN& NN N NNNNNNN NN& NN N NNNNNNN NN& NN N NNNNNNN NN& NN N NNNNNNNN
+NNNN   & %N N NNNNNNN   & %N N NNNNNNN   & %N N NNNNNNN   & %N N NNNNNNN   & %N N NNNNNNN   & %N N NNNNNNN   & %N N NNNNNNN   & %N N NNNNNNNN
+NNNN  (&NNN N NNNNNNN  (&NNN N NNNNNNN  (&NNN N NNNNNNN  (&NNN N NNNNNNN  (&NNN N NNNNNNN  (&NNN N NNNNNNN  (&NNN N NNNNNNN  (&NNN N NNNNNNNN
+N%    %&NNN N          %&NNN N          %&NNN N          %&NNN N          %&NNN N          %&NNN N          %&NNN N          %&NNN N       %N
+NNN NNN&NNN NNNNNNNN NNN&NNN NNNNNNNN NNN&NNN NNNNNNNN NNN&NNN NNNNNNNN NNN&NNN NNNNNNNN NNN&NNN NNNNNNNN NNN&NNN NNNNNNNN NNN&NNN NNNNNNNNNN
+N%    N&NNN            N&NNN            N&NNN            N&NNN            N&NNN            N&NNN            N&NNN            N&NNN         %N
+NNNNN N&NNN NNNNNNNNNN N&NNN NNNNNNNNNN N&NNN NNNNNNNNNN N&NNN NNNNNNNNNN N&NNN NNNNNNNNNN N&NNN NNNNNNNNNN N&NNN NNNNNNNNNN N&NNN NNNNNNNNNN
+NN    N&N       NNN    N&N       NNN    N&N       NNN    N&N       NNN    N&N       NNN    N&N       NNN    N&N       NNN    N&N       NNNNNN
+NN NNNN&N NNNNN NNN NNNN&N NNNNN NNN NNNN&N NNNNN NNN NNNN&N NNNNN NNN NNNN&N NNNNN NNN NNNN&N NNNNN NNN NNNN&N NNNNN NNN NNNN&N NNNNN NNNNNN
+NN    N&N   N   NNN    N&N   N   NNN    N&N   N   NNN    N&N   N   NNN    N&N   N   NNN    N&N   N   NNN    N&N   N   NNN    N&N   N   NNNNNN
+NNNNN N&NNN N NNNNNNNN N&NNN N NNNNNNNN N&NNN N NNNNNNNN N&NNN N NNNNNNNN N&NNN N NNNNNNNN N&NNN N NNNNNNNN N&NNN N NNNNNNNN N&NNN N NNNNNNNN
+NNNN%  &%   N    NNNN%  &%   N    NNNN%  &%   N    NNNN%  &%   N    NNNN%  &%   N    NNNN%  &%   N    NNNN%  &%   N    NNNN%  &%   N    NNNNN
+NNNNN=N&N NNNNNN NNNNN=N&N NNNNNN NNNNN=N&N NNNNNN NNNNN=N&N NNNNNN NNNNN=N&N NNNNNN NNNNN=N&N NNNNNN NNNNN=N&N NNNNNN NNNNN=N&N NNNNNN NNNNN
+NNNNN %&  %N     NNNNN %&  %N     NNNNN %&  %N     NNNNN %&  %N     NNNNN %&  %N     NNNNN %&  %N     NNNNN %&  %N     NNNNN %&  %N     NNNNN
+NNNNN N&NNNN NNNNNNNNN N&NNNN NNNNNNNNN N&NNNN NNNNNNNNN N&NNNN NNNNNNNNN N&NNNN NNNNNNNNN N&NNNN NNNNNNNNN N&NNNN NNNNNNNNN N&NNNN NNNNNNNNN
+NNNN%  &%    NNNNNNNN%  &%    NNNNNNNN%  &%    NNNNNNNN%  &%    NNNNNNNN%  &%    NNNNNNNN%  &%    NNNNNNNN%  &%    NNNNNNNN%  &%    NNNNNNNNN
+NNNNN=N&N NNNNNNNNNNNN=N&N NNNNNNNNNNNN=N&N NNNNNNNNNNNN=N&N NNNNNNNNNNNN=N&N NNNNNNNNNNNN=N&N NNNNNNNNNNNN=N&N NNNNNNNNNNNN=N&N NNNNNNNNNNNN
+NNNNN %&  %NNNNNNNNNNN %&  %NNNNNNNNNNN %&  %NNNNNNNNNNN %&  %NNNNNNNNNNN %&  %NNNNNNNNNNN %&  %NNNNNNNNNNN %&  %NNNNNNNNNNN %&  %NNNNNNNNNNN
+NNNNN N&N=NNNNNNNNNNNN N&N=NNNNNNNNNNNN N&N=NNNNNNNNNNNN N&N=NNNNNNNNNNNN N&N=NNNNNNNNNNNN N&N=NNNNNNNNNNNN N&N=NNNNNNNNNNNN N&N=NNNNNNNNNNNN
+NNNN%  &% NNNNNNNNNNN%  &% NNNNNNNNNNN%  &% NNNNNNNNNNN%  &% NNNNNNNNNNN%  &% NNNNNNNNNNN%  &% NNNNNNNNNNN%  &% NNNNNNNNNNN%  &% NNNNNNNNNNNN
+NNNNN=N&N NNNNNNNNNNNN=N&N NNNNNNNNNNNN=N&N NNNNNNNNNNNN=N&N NNNNNNNNNNNN=N&N NNNNNNNNNNNN=N&N NNNNNNNNNNNN=N&N NNNNNNNNNNNN=N&N NNNNNNNNNNNN
+NNNNN %&  %NNNNNNNNNNN %&  %NNNNNNNNNNN %&  %NNNNNNNNNNN %&  %NNNNNNNNNNN %&  %NNNNNNNNNNN %&  %NNNNNNNNNNN %&  %NNNNNNNNNNN %&  %NNNNNNNNNNN
+NNNNN N&N=NNNNNNNNNNNN N&N=NNNNNNNNNNNN N&N=NNNNNNNNNNNN N&N=NNNNNNNNNNNN N&N=NNNNNNNNNNNN N&N=NNNNNNNNNNNN N&N=NNNNNNNNNNNN N&N=NNNNNNNNNNNN
+NN j%  &%hNNNNNNNNN j%  &%hNNNNNNNNN j%  &%hNNNNNNNNN j%  &%hNNNNNNNNN j%  &%hNNNNNNNNN j%  &%hNNNNNNNNN j%  &%hNNNNNNNNN j%  &%hNNNNNNNNNNNN
+NN+NNNNNNkNNNNNNNNN+NNNNNNkNNNNNNNNN+NNNNNNkNNNNNNNNN+NNNNNNkNNNNNNNNN+NNNNNNkNNNNNNNNN+NNNNNNkNNNNNNNNN+NNNNNNkNNNNNNNNN+NNNNNNkNNNNNNNNNNNN
+@ +     %          +     %          +     %          +     %         1+     %          +     %          +     %         2+     %            N
+NNNNNNNNN=NNNNNNNNNNNNNNNN=NNNNNNNNNNNNNNNN=NNNNNNNNNNNNNNNN=NNNNNNNNNNNNNNNN=NNNNNNNNNNNNNNNN=NNNNNNNNNNNNNNNN=NNNNNNNNNNNNNNNN=NNNNNNNNNNNN
+NNNNNNN%&  NNNNNNNNNNNNN%&  NNNNNNNNNNNNN%&  NNNNNNNNNNNNN%&  NNNNNNNNNNNNN%&  NNNNNNNNNNNNN%&  NNNNNNNNNNNNN%&  NNNNNNNNNNNNN%&  NNNNNNNNNNN
+NNNNNNNNKN NNNNNNNNNNNNNNKN NNNNNNNNNNNNNNKN NNNNNNNNNNNNNNKN NNNNNNNNNNNNNNKN NNNNNNNNNNNNNNKN NNNNNNNNNNNNNNKN NNNNNNNNNNNNNNKN NNNNNNNNNNN
+NNNNNNNNN% & NNNNNNNNNNNNN% & NNNNNNNNNNNNN% & NNNNNNNNNNNNN% & NNNNNNNNNNNNN% & NNNNNNNNNNNNN% & NNNNNNNNNNNNN% & NNNNNNNNNNNNN% & NNNNNNNNN
+NNNNNNNNNNNNINNNNNNNNNNNNNNNINNNNNNNNNNNNNNNNNINNNNNNNNNNNNNNNNINNNNNNNNNNNNNNNINNNNNNNNNNNNNNNNINNNNNNNNNNNNNNNNINNNNNNNNNNNNNNNNNINNNNNNNNN
+                                                                                                                                          iQN
NNNNNNNNNNNNNNNNNNNNNNNNNNNNNNNNNNNNNNNNNNNNNNNNNNNNNNNNNNNNNNNNNNNNNNNNNNNNNNNNNNNNNNNNNNNNNNNNNNNNNNNNNNNNNNNNNNNNNNNNNNNNNNNNNNNNNNNNNNHNNN
