#############
#     $     #
#$$   #   $$#####
# @   %     a Q #
#########A#######
