#############
#     $     #
#$$   #   $$#####
# @   %     g Q #
#########G#######
