name: Chapter 1 Fling
message1: To pass this you must fling your self through portals
NNNNNNNNNNNNNNNNNNNNNNNNNNNNNNNNNNNNNNNN
NNNNNNNNNNNNNNNNNNNNNNNNNNNNNNNNNNNNNNNN
NNNNNNNNNNNNNNNNNNNNNNNNNNNNNNNNNNNNNNNN
NNNNNNNNNNNNNNNNNNNNNNNNNNNNNNNNNNNNNNNN
NNNNNNNNNNNNNNNNNNNNNNNNNNNNNNNNNNNNNNNN
NNNNNNNNNNNNNNNNNNNNNNNNNNNNNNNNNNNNNNNN
NNNNNNNNNNNNNNNNNNNNNNNNNNNNNNNNNNNNNNNN
NNNNNNNNNNNNNNNNNNNNNNNNNNNNNNNNNNNNNNNN
NNNNNNNNNNNNNNNNNNNNNNNNNNNNNNNNNNNNNNNN
NNNNNNNNNNNNNNNNNNNNNNNNNNNNNNNNNNNNNNNN
NNNNNNNNNNNNNNNNNNNNNNNNNNNNNNNNNNNNNNNN
NNNNNNNN##        NNNNNNNNNNNNNNNNNNNNNN
NNNNNNNN##       QNNNNNNNNNNNNNNNNNNNNNN
NNNNNNNN##   NNNNNNNNNNNNNNNNNNNNNNNNNNN
NNNNNNNN##   NNNNNNNNNNNNNNNNNNNNNNNNNNN
NNNNNNNN##        NNNNNNNNNNNNNNNNNNNNNN
NNNNNNNN##        NNNNNNNNNNNNNNNNNNNNNN
NNNNNNNN##11      NNNNNNNNNNNNNNNNNNNNNN
NNNNNNNN##@1      NNNNNNNNNNNNNNNNNNNNNN
NNNNNNNN##########NNNNNNNNNNNNNNNNNNNNNN
NNNNNNNN##########NNNNNNNNNNNNNNNNNNNNNN
NNNNNNNNNNNNNNNNNNNNNNNNNNNNNNNNNNNNNNNN
NNNNNNNNNNNNNNNNNNNNNNNNNNNNNNNNNNNNNNNN
NNNNNNNNNNNNNNNNNNNNNNNNNNNNNNNNNNNNNNNN
NNNNNNNNNNNNNNNNNNNNNNNNNNNNNNNNNNNNNNNN