name Chapter 3 Infinite Portals
NNNNNNNNNNNNNNNNNNNNNNNNNNNNNNNNNNNNNN
NNNNNNNNNNNNNNNNNNNNNNNNNN#NNNNNNNNNNN
NNNNNNNNNNNNNNNNNNNNNN         #NNNNNN
NNNNNNNQ                       #NNNNNN
NNNNNNNNNNNNNNNNNNNNNNN        #NNNNNN
NNNNNNN@1                      #NNNNNN
NNNNNNNNNNNNNNN#NNNNNNNNNN#NNNNNNNNNNN
NNNNNNNNNNNNNNNNNNNNNNNNNNNNNNNNNNNNNN
NNNNNNNNNNNNNNNNNNNNNNNNNNNNNNNNNNNNNN