name: Chapter 4 Industry Standards
message1: You didn't even have to go that way, why don't you come back.
NNNNNNNNNNNNNNNNNNNNNNNNNNNNNNNNNNNNNNNNNNNNNNNNNNNNNN
NNNNNNNNNNNNNNNNNNNNNNNNNNNNNNNNNNNNNNNNNNNNNNNNNNNNNN
NNNNNNNNNNNNNNNNNNNNNNNNNNNNNNNNNNNNNNNNNNNNNNNNNNNNNN
NNNNNNNNNNNNNNNNNNNNNNNNNNNNNNNNNNNNNNN#NNNNNNNNNNNNNN
NNNNNQ                         NNNNNNNN#NNNNNNNNNNNNNN
NNNNNNNNNNNNNNNN                         NNNNNNNNNNNNN
NNNNNNNNNNNNNNNN$$$$$$$$$$$$$$$NNNNNNNNgNNNNNNNNNNNNNN
NNNNN                          NNNNNNNN  NNNNNNNNNNNNN
NNNNN@                         NNNNNNNN  NNNNNNNNNNNNN
NNNNNNNNNNNNNNNNNNNNN++NNNNNNNNNNNNNNNN  NNNNNNNNNNNNN
NNNNNNNNNNNNNNNNNNNNN++NNNNNNNNNNNNNNNN  NNNNNNNNNNNNN
NNNNNNNNNNNNNNNNNNNNN++NNNNNNNNNNNNNNNN  NNNNNNNNNNNNN
NNNNNNNNNNNNNNNNNNNNN++NNNNNNNNNNNNNNNN  NNNNNNNNNNNNN
NNNNNNNNNNNNNNNNNNNNN++NNNNNNNNNNNNNNNN  NNNNNNNNNNNNN
NNNNNOOOOOOO     NNNN          NNNNNNNN  NNNNNNNNNNNNN
NNNNN========NNNNNNNN          NNNNNNNN  NNNNNNNNNNNNN
NNNNN                          NNNNNNNN  NNNNNNNNNNNNN
NNNNN                          NNNNNNNN  NNNNNNNNNNNNN
NN++%                          NNNNNNNN  NNNNNNNNNNNNN
NN++%                          NNNNNNNN  NNNNNNNNNNNNN
NN++%%%%%%%%%NNNNNNNNNNNNNNNNNNNNNNNNNN  NNNNNNNNNNNNN
NN++NNNNNNNNNNNNNNNOOOOO     NNNNNNNNNN  NNNNNNNNNNNNN
NN  NNNNNNNNNNNNNNN=======NNNNNNNNNNNNN  NNNNNNNNNNNNN
NN                           NNNNNNNNNN  NNNNNNNNNNNNN
NNNNNNNNNNNNNNNNNNN          NNNNNNNNNN  NNNNNNNNNNNNN
NNNNNNNNNNNNNNNNNNN%%%%%%%%   NNNNNNNNN  NNNNNNNNNNNNN
NNNNNNNNNNNNNNNNNNNNNNNNNNNNN NNNNNNNNN  NNNNNNNNNNNNN
NNNNNNNNNNNNNNNNNNNNNNNNNNNNN NNNNNNNNN  NNNNNNNNNNNNN
NNNNNNNNNNNNNNNNNNNNNNNNNNNNN NNNNNNNNN  NNNNNNNNNNNNN
NNNNNNNNNNNNNNNNNNNNNNNNNNNNN NNNNNNNNN  NNNNNNNNNNNNN
NNNNNNNNNNNNNNNNNNNNNNNNNNNNN NNNNNNNNN  NNNNNNNNNNNNN
NNNNNNNNNNNNNNNNNNNNNNNNNNNNN NNNNNNNNN  NNNNNNNNNNNNN
NNNNO NO NNO NNO NNO NNNNNN   NNNNNNNNN  NNNNNNNNNNNNN
NNNN=NN=NNN=NNN=NNN=NNNNNNN NNNNNNNNNNN  NNNNNNNNNNNNN
                                 NNNNNN  NNNNNNNNNNNNN
N NN%NN%NNN%NNN%NNN%NNNNNNNNNNNNNNNNNNN  NNNNNNNNNN#NN
N NNNNNNNNNNNNNNNNNNNNNNNNNNNNNNNNNNNNN             NN
N NNNNNNNNNNNNNNNNNNNNNNNNNNNNNNNNNNNNNGNNNNNNNNNNN NN
N NNNNNNNNNNNNNNNNNNNNNNNNNNNNNNNNNNNNNNNNNNNNNNNNN NN
N NNNNNNNNNNNNNNNNNNNNNNNNNNNNNNNNNNNNNNNNNNNNNNNNN NN
N NNNNOOOOOOOOOOOOOOOOOOOOOO                      N NN
N NNNN======================NNNNNNNNNNNNNNNNNNNNNNN NN
N                           %              1        NN
NNNNNN%%%%%%%%%%%%%%%%%%%%%%%NNNNNNNNNNNNNNNNNNNNNN#NN
NNNNNNNNNNNNNNNNNNNNNNNNNNNNNNNNNNNNNNNNNNNNNNNNNNNNNN
NNNNNNNNNNNNNNNNNNNNNNNNNNNNNNNNNNNNNNNNNNNNNNNNNNNNNN
NNNNNNNNNNNNNNNNNNNNNNNNNNNNNNNNNNNNNNNNNNNNNNNNNNNNNN
NNNNNNNNNNNNNNNNNNNNNNNNNNNNNNNNNNNNNNNNNNNNNNNNNNNNNN
NNNNNNNNNNNNNNNNNNNNNNNNNNNNNNNNNNNNNNNNNNNNNNNNNNNNNN
NNNNNNNNNNNNNNNNNNNNNNNNNNNNNNNNNNNNNNNNNNNNNNNNNNNNNN
NNNNNNNNNNNNNNNNNNNNNNNNNNNNNNNNNNNNNNNNNNNNNNNNNNNNNN
NNNNNNNNNNNNNNNNNNNNNNNNNNNNNNNNNNNNNNNNNNNNNNNNNNNNNN
NNNNNNNNNNNNNNNNNNNNNNNNNNNNNNNNNNNNNNNNNNNNNNNNNNNNNN
NNNNNNNNNNNNNNNNNNNNNNNNNNNNNNNNNNNNNNNNNNNNNNNNNNNNNN
NNNNNNNNNNNNNNNNNNNNNNNNNNNNNNNNNNNNNNNNNNNNNNNNNNNNNN




