name: Chapter 4 Why is Test 23 Broken?
message1: You know I can kill anytime right? So why don't you just come back and I won't. This test is broken anyways.
NNNNNNNNNNNNNNNNNNNNNNNNNNNNNNNNNNNNNNNNNNNNNN
NNNNNNNNNNNNNNNNNNNNNNNNNNNNNNNNNNNNNNNNNNNNNN
NNNNNNNNNNNNNNNNNNNNNNNNNNNNNNNNNNNNNNNNNNNNNN
NNNNNNNNNNNNNNNNNNNNN            NNNNNNNNNNNNN
NNNNNNNNNNNNNNNNNNNNN           ONNNNNNNNNNNNN
NNNNNNNNNNNNNNNNNNNNN====###NNNN##########NNNN
NNNNNNNNNNNNNNNN                        ##NNNN
NNNNNNNNNNNNNNNN  & NNNNNNNN            ##NNNN
NNNNNNNNNNN###########NNNNNN            ##NNNN
NNNNN#     g   &     ######NbbbbbbbbbbbbNNNNNN
NNNNN#     g##########     a            NNNNNN
NNNNN#                     a            NNNNNN
NNNNN#@1                   a            NNNNNN
NNNNNNNNNGNA#############ANNNN        NNNNNNNN
NNNNNNNNNNNNNNNNNNNNNNNNNNNNNN        NNNNNNNN
NNNNNNNNNNNNNNNNNNNNNNNNNNNNNN        NNNNNNNN
NNNNNNNNNNNNNNNNNNNNNNNNNNNNNN        NNNNNNNN
NNNNNNNNNNNNNNNNNNNNNNNNNNNNNN        NNNNNNNN
NNNNNNNNNNNNNNNNNNNNNNNNNNNNNN        NNNNNNNN
NNNNNNNNNNNNNNNNNNNNNNNNNNNNNN        NNNNNNNN
NNNNNNNNNNNNNNNNNNNNNNNNNNNNNN        NNNNNNNN
NNNNNNNNNNNNNNNNNNNNNNNNNNNNNN        NNNNNNNN
NNNNNNNNNNNNNNNNNNNNNNNNNNNNNN        NNNNNNNN
NNNNNNNNNNNNNNNNNNNNNNNNNNNNNN        NNNNNNNN
NNNNNNNNNNNNNNNNNNNNNNNNNNNNNN        NNNNNNNN
NNNNNNNNNNNNNNNNNNNNNNNNNNNNNN        NNNNNNNN
NNNNNNNNNNNNNNNNNNNNNNNNNNNNNN        NNNNNNNN
NNNNNNNNNNNNNNNNNNNNNNNNNNNNNN        NNNNNNNN
NNNNNNNNNNNNNNNNNNNNNNNNNNNNNN        NNNNNNNN
NNNNNNNNNNNNNNNNNNNNNNNNNNNNNN        NNNNNNNN
NNNNNNNNNNNNNNNNNNNNNNNNNNNNNNQQQQQQQQNNNNNNNN