name: Chapter 5 Long Fall
NNNNNNNNNNNNNNNNNNNNNNNNNNNNNNNNNNNNN
NNNNNNNNNNNNNNNNNNNNNNNNNNNNNNNNNNNNN
NNNNNNNNNN            @   NNNNNNNNNNN
NNNNNNNNNN                NNNNNNNNNNN
NNNNNNNNNN                NNNNNNNNNNN
NNNNNNNNNN                NNNNNNNNNNN
NNNNNNNNNN                NNNNNNNNNNN
NNNNNNNNNN                NNN#NNNNNNN
NNNNNNNNNN                NN#NNNNNNNN
NNNNNNNNNN                NNNNNNNNNNN
NNNNNNNNNN                NNNN#NNNNNN
NNNNNNNNNN                NN#NNNNNNNN
NNNNNNNNNN                NNNNNNNNNNN
NNNNNNNNNN                NNNNNN#NNNN
NNNNNNNNNN                NNNN#NNNNNN
NNNNNNNNNN                NNNNNNNNNNN
NNNNNNNNNN                NN#NNNNNNNN
NNNNNNNNNN                NNNNNNNNNNN
NNNNNNNNNN                NNNNNN#NNNN
NNNNNNNNNN                NNNNNNNNNNN
NNNNNNNNNN                NNNN#NNNNNN
NNNNNNNNNN                NNNNNNNNNNN
NNNNNNNNNN                NN#NNNNNNNN
NNNNNNNNNN                NNNNN#NNNNN
NNNNNNNNNN                NNNNNNNNNNN
NNNNNNNNNN                NNNNNNNNNNN
NNNNNNNNNN                NNNNNN#NNNN
NNNNNNNNNN                NN#NNNNNNNN
NNNNNNNNNN                NNNNNNNNNNN
NNNNNNNNNN                NNNNNNNNNNN
NNNNNNNNNN                NNNNNNNNNNN
NNNNNNNNNN                NNNNNNNNNNN
NNNNNNNNNN                NNN#NNNNNNN
NNNNNNNNNN                NN#NNNNNNNN
NNNNNNNNNN                NNNNNNNNNNN
NNNNNNNNNN                NNNN#NNNNNN
NNNNNNNNNN                NN#NNNNNNNN
NNNNNNNNNN                NNNNNNNNNNN
NNNNNNNNNN                NNNNNN#NNNN
NNNNNNNNNN                NNNN#NNNNNN
NNNNNNNNNN                NNNNNNNNNNN
NNNNNNNNNN                NN#NNNNNNNN
NNNNNNNNNN                NNNNNNNNNNN
NNNNNNNNNN                NNNNNN#NNNN
NNNNNNNNNN                NNNNNNNNNNN
NNNNNNNNNN                NNNN#NNNNNN
NNNNNNNNNN                NNNNNNNNNNN
NNNNNNNNNN                NN#NNNNNNNN
NNNNNNNNNN                NNNNN#NNNNN
NNNNNNNNNN                NNNNNNNNNNN
NNNNNNNNNN                NNNNNNNNNNN
NNNNNNNNNN                NNNNNN#NNNN
NNNNNNNNNN                NN#NNNNNNNN
NNNNNNNNNN                NNNNNNNNNNN
NNNNNNNNNN                NNNNNNNNNNN
NNNNNNNNNN                NNNNNNNNNNN
NNNNNNNNNN                NNNNNNNNNNN
NNNNNNNNNN                NNN#NNNNNNN
NNNNNNNNNN                NN#NNNNNNNN
NNNNNNNNNN                NNNNNNNNNNN
NNNNNNNNNN                NNNN#NNNNNN
NNNNNNNNNN                NN#NNNNNNNN
NNNNNNNNNN                NNNNNNNNNNN
NNNNNNNNNN                NNNNNN#NNNN
NNNNNNNNNN                NNNN#NNNNNN
NNNNNNNNNN                NNNNNNNNNNN
NNNNNNNNNN                NN#NNNNNNNN
NNNNNNNNNN                NNNNNNNNNNN
NNNNNNNNNN                NNNNNN#NNNN
NNNNNNNNNN                NNNNNNNNNNN
NNNNNNNNNN                NNNN#NNNNNN
NNNNNNNNNN                NNNNNNNNNNN
NNNNNNNNNN                NN#NNNNNNNN
NNNNNNNNNN                NNNNN#NNNNN
NNNNNNNNNN                NNNNNNNNNNN
NNNNNNNNNN                NNNNNNNNNNN
NNNNNNNNNN                NNNNNN#NNNN
NNNNNNNNNN                NN#NNNNNNNN
NNNNNNNNNN                NNNNNNNNNNN
NNNNNNNNNN                NNNNNNNNNNN
NNNNNNNNNN                NNNNNNNNNNN
NNNNNNNNNN                NNNNNNNNNNN
NNNNNNNNNN                NNN#NNNNNNN
NNNNNNNNNN                NN#NNNNNNNN
NNNNNNNNNN                NNNNNNNNNNN
NNNNNNNNNN                NNNN#NNNNNN
NNNNNNNNNN                NN#NNNNNNNN
NNNNNNNNNN                NNNNNNNNNNN
NNNNNNNNNN                NNNNNN#NNNN
NNNNNNNNNN                NNNN#NNNNNN
NNNNNNNNNN                NNNNNNNNNNN
NNNNNNNNNN                NN#NNNNNNNN
NNNNNNNNNN                NNNNNNNNNNN
NNNNNNNNNN                NNNNNN#NNNN
NNNNNNNNNN                NNNNNNNNNNN
NNNNNNNNNN                NNNN#NNNNNN
NNNNNNNNNN                NNNNNNNNNNN
NNNNNNNNNN                NN#NNNNNNNN
NNNNNNNNNN                NNNNN#NNNNN
NNNNNNNNNN                NNNNNNNNNNN
NNNNNNNNNN                NNNNNNNNNNN
NNNNNNNNNN                NNNNNN#NNNN
NNNNNNNNNN                NN#NNNNNNNN
NNNNNNNNNN                NNNNNNNNNNN
NNNNNNNNNN                NNNNNNNNNNN
NNNNNNNNNN                NNNNNNNNNNN
NNNNNNNNNN                NNNNNNNNNNN
NNNNNNNNNN                NNN#NNNNNNN
NNNNNNNNNN                NN#NNNNNNNN
NNNNNNNNNN                NNNNNNNNNNN
NNNNNNNNNN                NNNN#NNNNNN
NNNNNNNNNN                NN#NNNNNNNN
NNNNNNNNNN                NNNNNNNNNNN
NNNNNNNNNN                NNNNNN#NNNN
NNNNNNNNNN                NNNN#NNNNNN
NNNNNNNNNN                NNNNNNNNNNN
NNNNNNNNNN                NN#NNNNNNNN
NNNNNNNNNN                NNNNNNNNNNN
NNNNNNNNNN                NNNNNN#NNNN
NNNNNNNNNN                NNNNNNNNNNN
NNNNNNNNNN                NNNN#NNNNNN
NNNNNNNNNN                NNNNNNNNNNN
NNNNNNNNNN                NN#NNNNNNNN
NNNNNNNNNN                NNNNN#NNNNN
NNNNNNNNNN                NNNNNNNNNNN
NNNNNNNNNN                NNNNNNNNNNN
NNNNNNNNNN                NNNNNN#NNNN
NNNNNNNNNN                NN#NNNNNNNN
NNNNNNNNNNQQQQQQQQQQQQQQQQNNNNNNNNNNN