name: Chapter 5 Oh Good, the pit really wasn't bottomless.
NNNNNNNNNNNNNNNNNNNNNNNNNNNNNNNNNNNNN
NNNNNNNNNNNNNNNNNNNNNNNNNNNNNNNNNNNNN
NNNNNNNNNN            @   NNNNNNNNNNN
NNNNNNNNNN                NNNNNNNNNNN
NNNNNNNNNN                NNNNNNNNNNN
NNNNNNNNNN                NNNNNNNNNNN
NNNNNNNNNN                NNNNNNNNNNN
NNNNNNNNNN                NNN#NNNNNNN
NNNNNNNNNN                NN#NNNNNNNN
NNNNNNNNNN                NNNNNNNNNNN
NNNNNNNNNN                NNNN#NNNNNN
NNNNNNNNNN                NN#NNNNNNNN
NNNNNNNNNN                NNNNNNNNNNN
NNNNNNNNNN                NNNNNNNNNNN
NNNNNNNNNN                         NN
NNNNNNNNNN                        QNN
NNNNNNNNNNNNNNNNNNNNNNNNNNNNNNNNNNNNN
NNNNNNNNNNNNNNNNNNNNNNNNNNNNNNNNNNNNN