name: Chapter 6 BTS Old Aperture
NNNNNNNNNNNNNNNNNNNNNNNNNNNNNNNNNNNNNNNNNNNNNNNNNNNNNNNNNNNNNNNNN
NNNNNNNNNNNNNNNNNNNNNNNNNNNNNNNNNNNNNNNNNNNNNNNNNNNNNNNNNNNNNNNNN
NNNNNNNNNNNNNNNNNNNNNNNNNNNNNNNNNNNNNNNNNNNNNNNNNNNNNNNNNNNNNNNNN
NNNNNNNNNNNNNNNNNNNNNNN&NNNNNNNNNNNNNNNNNNNNNNNNNNNNNNNNNNNNNNNNN
NNNNNNNNNNNNNNNNNNNNNNN&NNNNNNNNNNNNNNNNNNNNNNNNNNNNNNNNNNNNNNNNN
NNNNNNNNNNNNNNNNNNNNNNNbNNNNNNNNNNNNNNNNNNNNNNNNNNNNNNNNNNNNNNNNN
NNNNNNNNNNNNNNNNNNNNNQ     NNNNNNNN#NNNNNNNNNNNNNNNNNNNNNNNNNNNNN
NNNNNNNNNNNNN        NN N   h        #NNNNNNNNNNNNNNNNNNNNNNNNNNN
NNNNNNNNNNNNN   ####### ####A##      NN<NN         c<NNNNNNNNNNNN
NNNNNNNNNNNNN   ######&######        #N<NNMNINFNENDNNNNNNNNNNNNNN
NNNNNNNNNNNNN       ##h#####         #N<NNO<NNNO<NNO<NNO<NNNNNNNN
NNNNNNNNNNNNNNN         ######       NNcNNNdNNNeNNNfNNNiNNNNNNNNN
NNNNNNNNNNNNN N             h        a%                         N
NNN#            NNN         h        a%                       & N
NNN#@             #         g        NNNCNNNNNNNNNNNNNNNNNNNNNNBN
NNNNNNNNNNNNNNNNNNN########GN#H#NNNN#NNNNNNNNNNNNNNNNNNNNNNNNNNNN
NNNNNNNNNNNNNNNNNNNNNNNNNNNNNNNNNNNNNNNNNNNNNNNNNNNNNNNNNNNNNNNNN
NNNNNNNNNNNNNNNNNNNNNNNNNNNNNNNNNNNNNNNNNNNNNNNNNNNNNNNNNNNNNNNNN
NNNNNNNNNNNNNNNNNNNNNNNNNNNNNNNNNNNNNNNNNNNNNNNNNNNNNNNNNNNNNNNNN
NNNNNNNNNNNNNNNNNNNNNNNNNNNNNNNNNNNNNNNNNNNNNNNNNNNNNNNNNNNNNNNNN

