name: Chapter 6 BTS Particle Block
NNNNNNNNNNNNNNNNNNNNNNNNNNNNNNNNNNNNNNNNNNNNNNNNNNNNNNNNN
NNNNNNNNNNNNNNNNNNNNNNNNNNNNNNNNNNNNN&NNNNNNNNNNNNNNNNNNN
NNNNNNNNNNNNNNNNNNNNNNN#NNNNNNNNNNNNNgNNNNNNNNNNNNNNNNNNN
NNNN                #                                NNNN
NNNN                N      N                         NNNN
NNNN                       %                         NNNN
NNNN                       %                         NNNN
NNN#                       %                         NNNN
NNN#                       %                       hhNNNN
NNN#@                      %                       hQNNNN
NNNNNNNNNNNNNNNNNHNNNNN#NNNNNNNNNNN##G##NNNNNNNNNNNNNNNNN
NNNNNNNNNNNNNNNNNNNNNNNNNNNNNNNNNNNNNNNNNNNNNNNNNNNNNNNNN
NNNNNNNNNNNNNNNNNNNNNNNNNNNNNNNNNNNNNNNNNNNNNNNNNNNNNNNNN