name: Chapter 5 Advanced Particle Block
NNNNNNNNNNNNNNNNNNNNNNNNNNNNNNNNNNNNNNNNNNNNNNNNNNNNNNNNN
NNNNNNNNNNNNNNNNNNNNNNNNNNNNNNNNNNNNNNNNNNNNNNNNNNNNNNNNN
NNNNNNNNNNNNNNNNNNNNNNN#NNNNNNNNNNNNNNNNNNNNNNN#NNNNNNNNN
NNNN                #                                NNNN
NNNN                #      N                         NNNN
NNNN                       %                         NNNN
NNNN                       %                         NNNN
NNN#                       %                         NNNN
NNN#                       %                       hhNNNN
NNN#@                      %                       hQNNNN
NNNNNNNN+NNNNNNNNHNNNNN#NNNNNNNN#NNNNNNNNNNNNNNjNNNNNNNNN
NNNNNNNN+NNNNNNNNNNg<<<<i>>>>gNNNNNNNNNNNNNNNNN NNNNNNNNN
NNNNNNNN+#####NNNNNg####i####gNNNNNNNNNNNNNNNNN NNNNNNNNN
NNNN    +                   #                        #NNN
NNNN    +                   #                        #NNN
NNNN    +#####)))              (((NNNN            NNNNNNN
NNNN     ########)))))    (((((#######               NNNN
NNNN             #>>>>    <<<<#                      NNNN
NNNN"""""""""""""##############""""""""""""""""   """NNNN
NNNNNNNNNNNNNNNNNNNNNNNNNNNNNNNNNNNNNNNNNNNNNNN +NNNNNNNN
NNNNNNNNNNNNNNNNNNNNNNNNNNNNNNNNNNNNNNNNNNNNNNN +NNNNNNNN
NNNNNNNNNNNNNNNNNNNNNNNNNNNNNNNNNNNNNNNNNNNNNNN +NN###NNN
NNNNNNNNNNNNNNNNNNNNNNNNNNNNNNNNNNNNNNNNNN#     +    #NNN
NNNNNNNNNNNNNNNNNNNNNNNNNNNNNNNNNNNNNNNNNN#     +    #NNN
NNNNNNNNNNNNNNNNNNNNNNNNNNNNNNNNNNNNNNNNNN#     + &  #NNN
NNNNNNNNNNNNNNNNNNNNNNNNNNNNNNNNNNNNNNNNNN##NGNJNNNI##NNN
NNNNNNNNNNNNNNNNNNNNNNNNNNNNNNNNNNNNNNNNNNNNNNNNNNNNNNNNN