name: Chapter 6 BTS Mass Construct
NNNNNNNNNNNNNNNNNNNNNNNNNNNNNNNNNNNNNNNNNNNNNNNNNNNNNNNNNNNNNNNNNNNNNNNNNNNN
NNNNNNNNNNNNNNNNNNNNNNNNNNNNNNNNNNNNNNNNN##NNNNNNNNNNNNNNNNNNNNNNNNNNNNNNNNN
NNNNNNNNNNNNNNNNNNNNNNNNNNNNNNNNNNNNNNNNN         NNNNNNNNNNNNNNNNNNNNNNNNNN
NNNNNNNNNNNNNNNNNNNNNNNNNNNNNNNNNNNNNNNNN        QNNNNNNNNNNNNNNNNNNNNNNNNNN
NNNNNNNNNNNNNNNNNNNNNNNNNNNNNNNNNNNNNNNNN  NNNNNNNNNNNNNNNNNNNNNNNNNNNNNNNNN
NNNNNNNNNNNNNNNNNNNNNNNNNNNNNNNNNNNNNN>NN  NNNNNNNNNNNNNNNNNNNNNNNNNNNNNNNNN
NNNNNNNNNONNNNNNONNNNONNNNNNNN<NNNNNNN=NN  NNNONNNONNN>NNNNNNNNNNNNNNNNNNNNN
NNNNNNNNNONNNNNNONNNN=NNNNNNNN=NNNN##NgNN  NNNONNN=NNN=NNNNNNNNNNNNNNNNNNNNN
NNNNNNNNNONNNNNNONNNN   N NNN    N #    $  #NNON     N  NNNNNNNNNNNNNNNNNNNN
NNNNNNNNNONNNNNNONNNNNN NONNNNNN NON NNNNNNNNNON NNON   ###NNNNNN&NNNNNNNNNN
NNNNNNNNN=NNNNNN=NNNNNN N=NNNNNN N=N NNNNNNNNN=N NN=N NN#     NNN=NNNNNNNNNN
NNNNNNNNNgNNNNNNgNNNNNNgNgNNNNNNgNgN NNNNNNNNNgNgNNgNgNN#     NNNiNNNNNNNNNN
NN%                                                                       NN
NN%@                                                       %&             NN
NNNNNNNNNgNNNNNNgNNNNNNgNgNNNNNNgNgNgNNNNNNNNNgNgNngNgNNNNNNGNNINN####HNNNNN
NNNNNNNNN%NNNNNN%NNNNNN%N%NNNNNN%N%N%NNNNNNNNN%N%NN%N%NNNNNNNNNNNNNNNNNNNNNN
NNNNNNNNNNNNNNNNNNNNNNNNNNNNNNNNNNNNNNNNNNNNNNNNNNNNNNNNNNNNNNNNNNNNNNNNNNNN
NNNNNNNNNNNNNNNNNNNNNNNNNNNNNNNNNNNNNNNNNNNNNNNNNNNNNNNNNNNNNNNNNNNNNNNNNNNN
NNNNNNNNNNNNNNNNNNNNNNNNNNNNNNNNNNNNNNNNNNNNNNNNNNNNNNNNNNNNNNNNNNNNNNNNNNNN
NNNNNNNNNNNNNNNNNNNNNNNNNNNNNNNNNNNNNNNNNNNNNNNNNNNNNNNNNNNNNNNNNNNNNNNNNNNN
NNNNNNNNNNNNNNNNNNNNNNNNNNNNNNNNNNNNNNNNNNNNNNNNNNNNNNNNNNNNNNNNNNNNNNNNNNNN
NNNNNNNNNNNNNNNNNNNNNNNNNNNNNNNNNNNNNNNNNNNNNNNNNNNNNNNNNNNNNNNNNNNNNNNNNNNN