name: Chapter 7 Vents II
NNNNNNNNNNNNNNNNNNNNNNNNNNNNNNNNNNNNNNNNNNNNNNNNNNNNNNNNNNNNNNNNNNNNNNNNNNN
NNNNNNNNNNNNNNNNNNNNNNNNNNNNNNNNNNNNNNNNNNNNNNNNNNNNNNNNNNNNNNNNNNNNNNNNNNN
NNNNNNNNNNNNNNNNNNNNNNNNNNNNNNNNNNNNNNNNNNNNNNNNNNNNNNNNNNNNNNNNNNNNNNNNNNN
NNNNNNNNNNNNNNNNNNNNNNNNNNNNNNNNNNNNNNNNNNNNNNNNNNNNNNNNNNNNNNNNNNNNNNNNNNN
NNNNNNNNNNNNNNNNNNNNNNNNNNNNNNNNNNNNNNNNNNNNNNNNNNNNNNNNNNNNNNNNNNNNNNNNNNN
NNNNNNNNNNNNNNNNN+NNNN+NNNNNNNNNNNNNNNNNNNNNNNNNNNNNNNNNNNNNNNNNNNNNNNNNNNN
NNNNNNNNNNNNNNNNN+NN+++++N++++++++NNNNNNNNNNNNNNNNNNNNNNNNNNNNNNNNNNNNNNNNN
NNNNNNNNNNNNNNNNN+NN+NNNNNNNNN+NN+NNNNNNNNNNNNNNNNNNNNNNNNNNNNNNNNNNNNNNNNN
NNNNNNNNNNNNNN++++NN+++++N+NNN+NN+NNNNNNNNNNNNNNNNNNNNNNNNNNNNNNNNNNNNNNNNN
NNNNNNNNNNNN+++NN+NN+NN+NN+++++NN+NNNNNNNNNNNNNNNNNNNNNNNNNNNNNNNNNNNNNNNNN
NNNNNNNNNNNN+N+NN+NN+NN++NNNNN++N+++N+++NNNNNNNNNNNNNNNNNNNNNNNNNNNNNNNNNNN
NNNNNNNNNNN++N++N++++NNN+NN+NNN+N+NNNNN+++NNN+NNNNNNNNNNNNNNNNNNNNNNNNNNNNN
NNNNNNNNNNN+NNN+NN+N+NNN+NN+NNN+N+NNNNN+N+NNN+NNNNNNNNNNNNNNNNNNNNNNNNNNNNN
NNNNNNNNNNN+NNN+NN+N+NNN+NN+NNN+++++N+NNN++NN+++NNNNNNNNNNNNNNNNNNNNNNNNNNN
NNNNNNNNNNN+NNN+NN+N++++++++++NNN+N+N+NNN+NNNNN+NNNNNNNNNNNNNNNNNNNNNNNNNNN
NNNNNNNNNNN+++++NN++++NNNNN+N+NNN+N+N+++NNNNN++++NNNNNNNNNNNNNNNNNNNNNNNNNN
NNNNNNNNNNN+NNNNNN+NNNNNNNN+N+NNN+N+NNN+++++NN+N+NNNNNNNNNNNNNNNNNNNNNNNNNN
NNNNNNNNNNN+NN+++++NNNN+++++++++++++N+++NN+NNN+NNNNNNNNNNNNNNNNNNNNNNNNNNNN
NNNNNNNNNNN+NN+NNNNNN+N+N+NNNN+NNNNNN+NNNN+++++NNNNNNNNNNNNNNNNNNNNNNNNNNNN
NNNNNN+++++++++N++++++N+N++++++NN+NN+++++++NNN+NNNNNNNNNNNNNNNNNNNNNNNNNNNN
NNNNNN+NNNNNNN+N+NNNNNNNNNN+NN+++++++NNNN+NNNN+NNNNNNNNNNNNNNNNNNNNNNNNNNNN
NNNNNN+NNNNN+NNNNNNNNNN+NNNNNN+NN+NN+NN+++NNQ++NNNNNNNNNNNNNNNNNNNNNNNNNNNN
NNNN@+++++++++++++++NN++++++++++++NNNNN+NNNNNNNNNNNNNNNNNNNNNNNNNNNNNNNNNNN
NNNNNN+NNNNNNNNNNNNNNNN+NNNNNNNNNNNNNN++NNNNNNNNNNNNNNNNNNNNNNNNNNNNNNNNNNN
NNNNNN+NNNNN+N+N+NNNNNN+NNNNNNNNNNNNNNN+NNNNNNNNNNNNNNNNNNNNNNNNNNNNNNNNNNN
NNNNNN+++++++++N++++++N+NNNN++++++NNNNN+NNNNNNNNNNNNNNNNNNNNNNNNNNNNNNNNNNN
NNNNNNNN+NN+N+NN+NNNN+N++++NNNNNN+++NNN+NNNNNNNNNNNNNNNNNNNNNNNNNNNNNNNNNNN
NNNNNNNN+NN+++NN+NNNN+NN+NNNNNNNN+NNNNN+NNNNNNNNNNNNNNNNNNNNNNNNNNNNNNNNNNN
NNNNNNNN+NN+NNNN+NNNN+NN+NN+NNNNN++++NN+NNNNNNNNNNNNNNNNNNNNNNNNNNNNNNNNNNN
NNNNNNNN+NN++++++N+++++++NN+++++++NNNNN+NNNNNNNNNNNNNNNNNNNNNNNNNNNNNNNNNNN
NNNNNNNN+NNNNNN+NN+NN+NN++++NN+NNNN+++++NNNNNNNNNNNNNNNNNNNNNNNNNNNNNNNNNNN
NNNNNNNN+NNNNNN+NN+NN+NNNNN+NN+NNNN+NNNNNNNNNNNNNNNNNNNNNNNNNNNNNNNNNNNNNNN
NNNNNNNN++++++++NN+NN+NNNNN+NNNNNNN+NNNNNNNNNNNNNNNNNNNNNNNNNNNNNNNNNNNNNNN
NNNNNNNNNNNNNNN+++++++N+++++++NNN+++NNNNNNNNNNNNNNNNNNNNNNNNNNNNNNNNNNNNNNN
NNNNNNNNNNNNNNNNN+NNNNN+NNNNNNNNNNNNNNNNNNNNNNNNNNNNNNNNNNNNNNNNNNNNNNNNNNN
NNNNNNNNNNNNNNNNN+NNNNN+NNNNNNNNNNNNNNNNNNNNNNNNNNNNNNNNNNNNNNNNNNNNNNNNNNN
NNNNNNNNNNNNNNNNN++NNN++NNNNNNNNNNNNNNNNNNNNNNNNNNNNNNNNNNNNNNNNNNNNNNNNNNN
NNNNNNNNNNNNNNNNNNNNNNNNNNNNNNNNNNNNNNNNNNNNNNNNNNNNNNNNNNNNNNNNNNNNNNNNNNN
NNNNNNNNNNNNNNNNNNNNNNNNNNNNNNNNNNNNNNNNNNNNNNNNNNNNNNNNNNNNNNNNNNNNNNNNNNN
NNNNNNNNNNNNNNNNNNNNNNNNNNNNNNNNNNNNNNNNNNNNNNNNNNNNNNNNNNNNNNNNNNNNNNNNNNN
NNNNNNNNNNNNNNNNNNNNNNNNNNNNNNNNNNNNNNNNNNNNNNNNNNNNNNNNNNNNNNNNNNNNNNNNNNN
NNNNNNNNNNNNNNNNNNNNNNNNNNNNNNNNNNNNNNNNNNNNNNNNNNNNNNNNNNNNNNNNNNNNNNNNNNN
NNNNNNNNNNNNNNNNNNNNNNNNNNNNNNNNNNNNNNNNNNNNNNNNNNNNNNNNNNNNNNNNNNNNNNNNNNN
NNNNNNNNNNNNNNNNNNNNNNNNNNNNNNNNNNNNNNNNNNNNNNNNNNNNNNNNNNNNNNNNNNNNNNNNNNN
NNNNNNNNNNNNNNNNNNNNNNNNNNNNNNNNNNNNNNNNNNNNNNNNNNNNNNNNNNNNNNNNNNNNNNNNNNN
NNNNNNNNNNNNNNNNNNNNNNNNNNNNNNNNNNNNNNNNNNNNNNNNNNNNNNNNNNNNNNNNNNNNNNNNNNN
NNNNNNNNNNNNNNNNNNNNNNNNNNNNNNNNNNNNNNNNNNNNNNNNNNNNNNNNNNNNNNNNNNNNNNNNNNN
NNNNNNNNNNNNNNNNNNNNNNNNNNNNNNNNNNNNNNNNNNNNNNNNNNNNNNNNNNNNNNNNNNNNNNNNNNN
NNNNNNNNNNNNNNNNNNNNNNNNNNNNNNNNNNNNNNNNNNNNNNNNNNNNNNNNNNNNNNNNNNNNNNNNNNN
NNNNNNNNNNNNNNNNNNNNNNNNNNNNNNNNNNNNNNNNNNNNNNNNNNNNNNNNNNNNNNNNNNNNNNNNNNN