name: Chapter 7 Vents III
NNNNNNNNNNNNNNNNNNNNNNNNNNNNNNNNNNNNNNNNNNNNNNNNNNNNNNNNNNNNNNNNNNNNNNNNNNN
NNNNNNNNNNNNNNNNNNNNNNNNNNNNNNNNNNNNNNNNNNNNNNNNNNNNNNNNNNNNNNNNNNNNNNNNNNN
NNNNNNNNNNNN++NNNNNNNNNNNNNNNNNNNNNNNNNNNNNNNNNNNNNNNNNNNNNNNNNNNNNNNNNNNNN
NNNNNNNNNNNN+NN+NN+++++NNNNNNNNN+++++NNNNNNNNNNNNNNNNNNNNNNNNNNNNNNNNNNNNNN
NNNNNNNNNN+++NN+NN+NNN+NN++NNNNN+NNN+NNNNNNNNNNNNNNNNNNNNNNNNNNNNNNNNNNNNNN
NNNNNNNNNN+N++++++++NN+NN+NNNNNN+++N+NNNNNNNNNNNNNNNNNNNNNNNNNNNNNNNNNNNNNN
NNNNNN+++N+NN+NNNNN+N+++++N++N+N+NNN+NNNNNNNNNNNNNNNNNNNNNNNNNNNNNNNNNNNNNN
NNNNNN+N+++NNNNNNNN+NNNN+NN+NN+NNNNN+NNNNNNNNNNNNNNNNNNNNNNNNNNNNNNNNNNNNNN
NNNNNN+NNN+++++NNNNNNN+++++++++++++N+NNNNNNNNNNNNNNNNNNNNNNNNNNNNNNNNNNNNNN
NNNN+++++N+NNNNNNNNNNN+NNNN+NNN+NNNN+NNNNNNNNNNNNNNNNNNNNNNNNNNNNNNNNNNNNNN
NNNN+NNN+N+N++++N+N++++NNNN+N++++++++N+NNNNNNNNNNNNNNNNNNNNNNNNNNNNNNNNNNNN
NNN++++N+N+N+NN+N+NNNN+NNNN+N+NNNNNNNN++N+NNNNNNNNNNNNNNNNNNNNNNNNNNNNNNNNN
NNN+NN+N+N+NNNN+++++NN+N+NN+N+NNNN+++++NN+NNNNNNNNNNNNNNNNNNNNNNNNNNNNNNNNN
NNNNNN+N+N+NNNN+NNN+NN+N+++++++++NN+NN+NN+NNNNNNNNNNNNNNNNNNNNNNNNNNNNNNNNN
NNN@+++++++N++++++N++++N+NNNNNNN+NN+NN++++NNNNNNNNNNNNNNNNNNNNNNNNNNNNNNNNN
NNNNNNN+N+NN+NN+NNNNNN+N+NNNN+NN+NN+NNNN+NNNNNNNNNNNNNNNNNNNNNNNNNNNNNNNNNN
NNNN++++N+NN+NN+NNNNNN+N+NNNN+NNNNN+N++N+NNNNNNNNNNNNNNNNNNNNNNNNNNNNNNNNNN
NNNN+NNNN+NN+NNNNNNNNN+NNNNNN+NN+NN+N+NN+NNNNNNNNNNNNNNNNNNNNNNNNNNNNNNNNNN
NNN++NNNNNNN+NNNN+++++++NNNN++++++++N+NQ+NNNNNNNNNNNNNNNNNNNNNNNNNNNNNNNNNN
NNN+NNNNNNN++NN+N+NNNNN++++N+NNN+NNNN+NNNNNNNNNNNNNNNNNNNNNNNNNNNNNNNNNNNNN
NNN+++NNNNNN+NN+N+N+++++NN+++N++++++++NNNNNNNNNNNNNNNNNNNNNNNNNNNNNNNNNNNNN
NNNNN+++++++++++N+++NNNNNN+NNNNNNN+NNNNNNNNNNNNNNNNNNNNNNNNNNNNNNNNNNNNNNNN
NNNNN+NNNNNN+N+NN+N+++N++++NNNNNNN+NNNNNNNNNNNNNNNNNNNNNNNNNNNNNNNNNNNNNNNN
NNNNN+NN+++++N+NN+NNN+N+NNN++N+++++NNNNNNNNNNNNNNNNNNNNNNNNNNNNNNNNNNNNNNNN
NNNNN+NN+NN+NNNNN++NN+N+NNN+NN+NN+NNNNNNNNNNNNNNNNNNNNNNNNNNNNNNNNNNNNNNNNN
NNNNN+NNNNN++++NNN+NN+++++++++++++NNNNNNNNNNNNNNNNNNNNNNNNNNNNNNNNNNNNNNNNN
NNNNN+NNN+N+NNNN+N+NNNNNNN+NNNNNN+NNNNNNNNNNNNNNNNNNNNNNNNNNNNNNNNNNNNNNNNN
NNNNNNNNN+N+NNNN+++NNNNN++++++N+++NNNNNNNNNNNNNNNNNNNNNNNNNNNNNNNNNNNNNNNNN
NNNNNNNNN+++NNNN+NNNN+NNNN+NNNNNNNNNNNNNNNNNNNNNNNNNNNNNNNNNNNNNNNNNNNNNNNN
NNNNNNNNNNN+NN+++++NN+NNNN+NNNNNNNNNNNNNNNNNNNNNNNNNNNNNNNNNNNNNNNNNNNNNNNN
NNNNNNNNNNNNNN+NNN+NN++++++NNNNNNNNNNNNNNNNNNNNNNNNNNNNNNNNNNNNNNNNNNNNNNNN
NNNNNNNNNNNNNN+NNNNNN+NNNNNNNNNNNNNNNNNNNNNNNNNNNNNNNNNNNNNNNNNNNNNNNNNNNNN
NNNNNNNNNNNNNNNNNNNNN+NNNNNNNNNNNNNNNNNNNNNNNNNNNNNNNNNNNNNNNNNNNNNNNNNNNNN
NNNNNNNNNNNNNNNNNNNN++NNNNNNNNNNNNNNNNNNNNNNNNNNNNNNNNNNNNNNNNNNNNNNNNNNNNN
NNNNNNNNNNNNNNNNNNNNNNNNNNNNNNNNNNNNNNNNNNNNNNNNNNNNNNNNNNNNNNNNNNNNNNNNNNN
NNNNNNNNNNNNNNNNNNNNNNNNNNNNNNNNNNNNNNNNNNNNNNNNNNNNNNNNNNNNNNNNNNNNNNNNNNN
NNNNNNNNNNNNNNNNNNNNNNNNNNNNNNNNNNNNNNNNNNNNNNNNNNNNNNNNNNNNNNNNNNNNNNNNNNN
NNNNNNNNNNNNNNNNNNNNNNNNNNNNNNNNNNNNNNNNNNNNNNNNNNNNNNNNNNNNNNNNNNNNNNNNNNN
NNNNNNNNNNNNNNNNNNNNNNNNNNNNNNNNNNNNNNNNNNNNNNNNNNNNNNNNNNNNNNNNNNNNNNNNNNN
NNNNNNNNNNNNNNNNNNNNNNNNNNNNNNNNNNNNNNNNNNNNNNNNNNNNNNNNNNNNNNNNNNNNNNNNNNN
NNNNNNNNNNNNNNNNNNNNNNNNNNNNNNNNNNNNNNNNNNNNNNNNNNNNNNNNNNNNNNNNNNNNNNNNNNN
NNNNNNNNNNNNNNNNNNNNNNNNNNNNNNNNNNNNNNNNNNNNNNNNNNNNNNNNNNNNNNNNNNNNNNNNNNN
NNNNNNNNNNNNNNNNNNNNNNNNNNNNNNNNNNNNNNNNNNNNNNNNNNNNNNNNNNNNNNNNNNNNNNNNNNN
NNNNNNNNNNNNNNNNNNNNNNNNNNNNNNNNNNNNNNNNNNNNNNNNNNNNNNNNNNNNNNNNNNNNNNNNNNN
NNNNNNNNNNNNNNNNNNNNNNNNNNNNNNNNNNNNNNNNNNNNNNNNNNNNNNNNNNNNNNNNNNNNNNNNNNN
NNNNNNNNNNNNNNNNNNNNNNNNNNNNNNNNNNNNNNNNNNNNNNNNNNNNNNNNNNNNNNNNNNNNNNNNNNN
NNNNNNNNNNNNNNNNNNNNNNNNNNNNNNNNNNNNNNNNNNNNNNNNNNNNNNNNNNNNNNNNNNNNNNNNNNN
NNNNNNNNNNNNNNNNNNNNNNNNNNNNNNNNNNNNNNNNNNNNNNNNNNNNNNNNNNNNNNNNNNNNNNNNNNN
NNNNNNNNNNNNNNNNNNNNNNNNNNNNNNNNNNNNNNNNNNNNNNNNNNNNNNNNNNNNNNNNNNNNNNNNNNN
NNNNNNNNNNNNNNNNNNNNNNNNNNNNNNNNNNNNNNNNNNNNNNNNNNNNNNNNNNNNNNNNNNNNNNNNNNN
NNNNNNNNNNNNNNNNNNNNNNNNNNNNNNNNNNNNNNNNNNNNNNNNNNNNNNNNNNNNNNNNNNNNNNNNNNN
NNNNNNNNNNNNNNNNNNNNNNNNNNNNNNNNNNNNNNNNNNNNNNNNNNNNNNNNNNNNNNNNNNNNNNNNNNN
NNNNNNNNNNNNNNNNNNNNNNNNNNNNNNNNNNNNNNNNNNNNNNNNNNNNNNNNNNNNNNNNNNNNNNNNNNN
NNNNNNNNNNNNNNNNNNNNNNNNNNNNNNNNNNNNNNNNNNNNNNNNNNNNNNNNNNNNNNNNNNNNNNNNNNN
NNNNNNNNNNNNNNNNNNNNNNNNNNNNNNNNNNNNNNNNNNNNNNNNNNNNNNNNNNNNNNNNNNNNNNNNNNN
NNNNNNNNNNNNNNNNNNNNNNNNNNNNNNNNNNNNNNNNNNNNNNNNNNNNNNNNNNNNNNNNNNNNNNNNNNN