name: Chapter 7 Vents IV
NNNNNNNNNNNNNNNNNNNNNNNNNNNNNNNNNNNN+++++N+N+N++++N
NNNNNNNNNNNNNNNNNNNNNNNNNNNNNNNNNNNN+N+N+N+N+N+NNNN
NNNNNNNNNNNNNNNNN++++++N+++++++NNNNNNN+N+++N+++++NN
NNNNNNNNN+++++++NNN+NNNN+N+NNNNNNNNNNN+NNNNNNN+NNNN
NNNNQ++NNNN+NNNNNNN+NNN++N+N+++NNNNN+++NNNNNNN+N+NN
NNNNNN+NN+++++++N+++++++NN+++N+NNNNN+NNNNNNN+++N+NN
NNNN+++NNNN+N+N+NNN+NNN+NNNNNNNNNN++++++++NN+N+++NN
NNNN+NNN+NN+N+N+N+++N+NNNNNNN++++++N+NNNN++++NNNNNN
NNNN+N+N+NNNN+N+N+N+N+NNNNNNN+NNNNNN+NNNN+NNNNNNNNN
NNNN+N+++++NN+NNN+N+++++++++++N+NNN+++N+++NNNNNNNNN
NNNN+NNN+N++++N+N+NNNNNN+NNNNNN+++NNNNNNN+NNNNNNNNN
NNNN+++N+N+NN+N+N+NNNNNN++++++++N+NNNN+NN+NNNNNNNNN
NNNNNN+NNN+N++N+++NNNNNNNNNNNNNNNNNNNN++++NNNNNNNNN
NNNN+N+++++N+NNNNNNNNNN++++++++N+++++NN+N+N+++++NNN
NNNN+NNNNNNN+NNNNNNNNNN+NNNNNN+N+N+NNNNNN+++N+N+NNN
NNNN+++N+N+++N+++++NNNN+++NNNN+++N+++++NN+NNN+N+NNN
NNNN+N+N+N+NNNNN+N+NNNNNN+NNNNNNNNNNNN+NNNNNNNN+NNN
NNNN+N+++N+++++N+N++++++N+NNNNNN+++++++++NNN++++NNN
NNNN+NNNNNNN+N+N+NNN+NNNN+NNNNNN+NNNNN+N+NNN+NNNNNN
NNNN+++++++++N+++NNN++++++++NN+++N+N+N+N+N+++NNNNNN
NNNN+NNNNNNNNNNNNNNNNNNNNNN+NN+NNN+N+NNN+NNN+NNNNNN
NNNN+++++N+++++N+++++++++NN+NN++++++++NN++NN+NNNNNN
NNNN+NNN+NNNNN+N+NNNNNNN++++NNN+NNNNN+NNN++++N+++NN
NNNN+N+++++N+++N+++++N+++NN+++N++NN+++NNN+NNNNNN+NN
NNNNNNNNNNNNNN+NNNNN+NNN+NNNNNNNNNN+N+NN++N+++N++NN
NNNNN+++++N++++++NNN+N+++N++++NNN+++N+NNNNN+N+NN+NN
NNNNN+NNN+N+NNNNNNNN+N+NNNNNN+NNNNNNN+N+N+N+N++++NN
NNNNN+NN++++N+++++NNNN+NNNNNN++NNNNNN+++++++NNNNNNN
NNNNN+NNNNNNN+NNN+N++N+N++NNNN+N+NN+NNN+NNN+NN+NNNN
NNNNN+N+++N+++NNN+N+NN+NN+NNNN+++NN+NNN+NNN++++NNNN
NNNNN+N+N+NNN+NNN+++NN+++++NNN+NNNN+++++N+++NNNNNNN
NNNNN+++N+NNN+NNNNN+NNNNNNNNNN+NNNNNN+NNNN+NNNNNNNN
NNNNNNNNN+NNN+NNNNN+N++N+N+++++++NNNN+++NNNNNNNNNNN
NNNNNN+++++N++NNNNN+NN+N+N+NNNNN+NN+NNN++NNNNNNNNNN
NNNNNN+NN+N++NN++NN++++++N+NNN+++NN+NNNN+NNNNNNNNNN
NNNN+N++N+N+NNN+NNNNNNN+NN+N+N+NNN+++++++NNN+++NNNN
NNNN+NN+NNN+NNN+NN+++NN++++N+++NNN+NN+NNNNNN+N+NNNN
NNNN++N+++++++++NNNN+NN+NNNNNNNNN++NN++NN++++N+NNNN
NNNN+NNNNNNNNNN++N+++NN++++NNNNNNNNNN+NNNNNN+NNNNNN
NNNN+++++++++NNN+NNN+N++NN+N+++NNNN+N+N++++++++NNNN
NNNNNNNN+N+N+N+N+NNN+NNNN++N+N+++NN+N+NNN+NN+NNNNNN
NNNNNNNNNN+NNN+N+NNN+NNNNNNN+N+NNNN+N+N+++NN+NN+NNN
NNNNNNNN+++++N+++NNN+++++N+N+N+++NN+++++NNNN+NN+NNN
NNNNNNNN+NNN+N+N++NNNN+N+N+N+N+NNNN+NNNNNN+N+NN+NNN
NNNNNNNN+++N+++NN++++++N+N+N+N+++NN++++++N++++++@NN
NNNNNNNNNNNNNNNNNNNNNNNNNN+N+NNN+NN+NNNNNNNNNNNNNNN
NNNNNNNNNNNNNNNNNNNNNN+++++++NNN++++NNNNNNNNNNNNNNN
NNNNNNNNNNNNNNNNNNNNNNN+NNNN+NNNNNNNNNNNNNNNNNNNNNN
NNNNNNNNNNNNNNNNNNNNNNNNNNNNNNNNNNNNNNNNNNNNNNNNNNN
NNNNNNNNNNNNNNNNNNNNNNNNNNNNNNNNNNNNNNNNNNNNNNNNNNN
NNNNNNNNNNNNNNNNNNNNNNNNNNNNNNNNNNNNNNNNNNNNNNNNNNN