name: Chapter 8 Furthered Development
NNNNNNNNNNNNNNNNNNNNNNNNNNNNNNNNNNNNNNNN
NN   a     a  NNNNNNNNNNNNNNNNNNNNNNNNNN
NN   ###B###  NNNNNNNNNNNNNNNNNNNNNNNNNN
NN            NNNNNNNNNNNNNNNNNNNNNNNNNN
NN        ##A#NNNNNNNNNNNNNNNNNNNNNNNNNN
NN@           NNNNNNNNNNNNNNNNNNNNNNNNNN
NN####        NNNNNNNNNNNNNNNNNNNNNNNNNN
NN            NNNNNNNNNNNNNNNNNNNNNNNNNN
NN            NNNNNNNNNNNNNNNNNNNNNNNNNN
NN            NNNNNNNNNNNNNNNNNNNNNNNNNN
NN            NNNNNNNNNNNNNNNNNNNNNNNNNN
NN            NNNNNNNNNNNNNNNNNNNNNNNNNN
NN  #####     NNNNNNNNNNNNNNNNNNNNNNNNNN
NN            NNNNNNNNNNNNNNNNNNNNNNNNNN
NN            NNNNNNNNNNNNNNNNNNNNNNNNNN
NN            NNNNNNNNNNNN##NNNNNNNNNNNN
NN            NNNNNNN  c    c#NNNNNNNNNN
NN            NNNNNNNQ c    c#NNNNNNNNNN
NN            NNNNNNNNNN    NNNNNNNNNNNN
NN          bbNNNNNNNN         NNNNNNNNN
NN          b NNNNNNNN         NNNNNNNNN
NNNNNNNN##### NNNNNNNN         NNNNNNNNN
NNNN                   NNN##NNNNNNNNNNNN
NNNN         NNNNNNNNNNNNNNNNNNNNNNNNNNN
NNNN      NNNNNNNNNNNNNNNNNNNNNNNNNNNNNN
NNNNC##   NNNNNNNNNNNNNNNNNNNNNNNNNNNNNN
NNNNNNN   NNNNNNNNNNNNNNNNNNNNNNNNNNNNNN
NNNNNNN   NNNNNNNNNNNNNNNNNNNNNNNNNNNNNN
NNNNNNN   NNNNNNNNNNNNNNNNNNNNNNNNNNNNNN
NNNNNNN   NNNNNNNNNNNNNNNNNNNNNNNNNNNNNN
NNNNNNN   NNNNNNNNNNNNNNNNNNNNNNNNNNNNNN
NNNNNNN   NNNNNNNNNNNNNNNNNNNNNNNNNNNNNN
NNNNNNN###NNNNNNNNNNNNNNNNNNNNNNNNNNNNNN
NNNNNNNNNNNNNNNNNNNNNNNNNNNNNNNNNNNNNNNN
NNNNNNNNNNNNNNNNNNNNNNNNNNNNNNNNNNNNNNNN
NNNNNNNNNNNNNNNNNNNNNNNNNNNNNNNNNNNNNNNN
NNNNNNNNNNNNNNNNNNNNNNNNNNNNNNNNNNNNNNNN
NNNNNNNNNNNNNNNNNNNNNNNNNNNNNNNNNNNNNNNN
NNNNNNNNNNNNNNNNNNNNNNNNNNNNNNNNNNNNNNNN
NNNNNNNNNNNNNNNNNNNNNNNNNNNNNNNNNNNNNNNN