name: Chapter 9 EndGame
music:pt.mp3
NNNNNNNNNNNNNNNNNNNNNNNNNNNNNNNNNNNNNNNNNNNNNNNNNNNNNNNNNNNNNNNNNNNNNNNNNNNNNNNNNNNNNNNNNNNNNNNNNNNN
NNNNNNNNNNNNNNNNNNNNNNNNNNNNNNNNN      0000NNNNNNNNNNNNNNNNNNNNNNNNNNNNNNNNNNNNNNNNNNNNNNNNNNNNNNNNN
NNNNNNNNNNNNNNNNNNNNNNNNNNNNNNNNN====NNNNNNNNNNNNNNNNNNNNNNNNNNNNNNNNNNNNNNNNNNNNNNNNNNNNNNNNNNNNNNN
NN                                             NNNNNNNNNNNNNNNNNNNNNNNNNNNNNNNNNNNNNNNNNNNNNNNNNNNNN
NN                                             NNNNNNNNNNNNNNNNNNNNNNNNNNNNNNNNNNNNNNNNNNNNNNNNNNNNN
NN NNNNNNNNNNNNNNNNNNNNNNNNNNNNNN%%%%NNNNNNNNNNNNNNNNNNNNNNNNNNNNNNNNNNNNNNNNNNNNNNNNNNNNNNNNNNNNNNN
NN NNNNNNNNNNNNNNNNNNNNNNNNNNNNNNNNNNNNNNNNNNNNNNNNNNNNNNNNNNNNNNNNNNNNNNNNNNNNNNNNNNNNNNNNNNNNNNNNN
NN NNNNNNNNNNNNNNNNNNNNNNNNNNNNNNNNNNNNNNNNNNNNNNNNNNNNNNNNNNNNNNNNNNNNNNNNNNNNNNNNNNNNNNNNNNNNNNNNN
NN NNNNNNNNNNNNNNNNNNNNNNNNNNNNNNNNNNNNNNNNNNNNNNNNNNNNNNNNNNNNNNNNNNNNNNNNNNNNNNNNNNNNNNNNNNNNNNNNN
NN NNNNNNNNNNNNNNNNNNNNNNNNNNNNNNNNNNNNNNNNNNNNNNNNNNNNNNNNNNNNNNNNNNNNNNNNNNNNNNNNNNNNNNNNNNNNNNNNN
NN NNNNNNNNNNNNNNNNNNNNNNNNNNNNNNNNNNNNNNNNNNNNNNNNNNNNNNNNNNNNNNNNNNNNNNNNNNNNNNNNNNNNNNNNNNNNNNNNN
NN NNNNNNNNNNNNNNNNNNNNNNNNNNNNNNNNNNNNNNNNNNNNNNNNNNNNNNNNNNNNNNNNNNNNNNNNNNNNNNNNNNNNNNNNNNNNNNNNN
NN NNNNNNNNNNNNNNNNNNNNNNNNNNNNNNNNNNNNNNNNNNNNNNNNNNNNNNNNNNNNNNNNNNNNNNNNNNNNNNNNNNNNNNNNNNNNNNNNN
NN NNNNNNNNNNNNNNNNNNNNNNNNNNNNNNNNNNNNNNNNNNNNNNNNNNNNNNNNNNNNNNNNNNNNNNNNNNNNNNNNNNNNNNNNNNNNNNNNN
NN NNNNNNNNNNNNNNNNNNNNNNNNNNNNNNNNNNNNNNNNNNNNNNNNNNNNNNNNNNNNNNNNNNNNNNNNNNNNNNNNNNNNNNNNNNNNNNNNN
NN NNNNNNNNNNNNNNNNNNNNNNNNNNNNNNNNNNNNNNNNNNNNNNNNNNNNNNNNNNNNNNNNNNNNNNNNNNNNNNNNNNNNNNNNNNNNNNNNN
NN NNNNNNNNNNNNNNNNNNNNNNNNNNNNNNNNNNNNNNNNNNNNNNNNNNNNNNNNNNNNNNNNNNNNNNNNNNNNNNNNNNNNNNNNNNNNNNNNN
NN NNNNNNNNNNNNNNNNNNNNNNNNNNNNNNNNNNNNNNNNNNNNNNNNNNNNNNNNNNNNNNNNNNNNNNNNNNNNNNNNNNNNNNNNNNNNNNNNN
NN NNNNNNNNNNNNNNNNNNNNNNNNNNNNNNNNNNNNNNNNNNNNNNNNNNNNNNNNNNNNNNNNNNNNNNNNNNNNNNNNNNNNNNNNNNNNNNNNN
NN NNNNNNNNNNNNNNNNNNNNNNNNNNNNNNNNNNNNNNNNNNNNNNNNNNNNNNNNNNNNNNNNNNNNNNNNNNNNNNNNNNNNNNNNNNNNNNNNN
NN NNNNNNNNNNNNNNNNNNNNNNNNNNNNNNNNNNNNNNNNNNNNNNNNNNNNNNNNNNNNNNNNNNNNNNNNNNNNNNNNNNNNNNNNNNNNNNNNN
NN NNNNNNNNNNNNNNNNNNNNNNNNNNNNNNNNNNNNNNNNNNNNNNNNNNNNNNNNNNNNNNNNNNNNNNNNNNNNNNNNNNNNNNNNNNNNNNNNN
NN NNNNNNNNNNNNNNNNNNNNNNNNNNNNNNNNNNNNNNNNNNNNNNNNNNNNNNNNNNNNNNNNNNNNNNNNNNNNNNNNNNNNNNNNNNNNNNNNN
NN NNNNNNNNNNNNNNNNNNNNNNNNNNNNNNNNNNNNNNNNNNNNNNNNNNNNNNNNNNNNNNNNNNNNNNNNNNNNNNNNNNNNNNNNNNNNNNNNN
NN NNNNNNNNNNNNNNNNNNNNNNNNNNNNNNNNNNNNNNNNNNNNNNNNNNNNNNNNNNNNNNNNNNNNNNNNNNNNNNNNNNNNNNNNNNNNNNNNN
NN NNNNNNNNNNNNNNNNNNNNNNNNNNNNNNNNNNNNNNNNNNNNNNNNNNNNNNNNNNNNNNNNNNNNNNNNNNNNNNNNNNNNNNNNNNNNNNNNN
NN NNNNNNNNNNNNNNNNNNNNNNNNNNNNNNNNNNNNNNNNNNNNNNNNNNNNNNNNNNNNNNNNNNNNNNNNNNNNNNNNNNNNNNNNNNNNNNNNN
NN NNNNNNNNNNNNNNNNNNNNNNNNNNNNNNNNNNNNNNNNNNNNNNNNNNNNNNNNNNNNNNNNNNNNNNNNNNNNNNNNNNNNNNNNNNNNNNNNN
NN NNNNNNNNNNNNNNNNNNNNNNNNNNNNNNNNNNNNNNNNNNNNNNNNNNNNNNNNNNNNNNNNNNNNNNNNNNNNNNNNNNNNNNNNNNNNNNNNN
NN NNNNNNNNNNNNNNNNNNNNNNNNNNNNNNNNNNNNNNNNNNNNNNNNNNNNNNNNNNNNNNNNNNNNNNNNNNNNNNNNNNNNNNNNNNNNNNNNN
NN NNNNNNNNNNNNNNNNNNNNNNNNNNNNNNNNNNNNNNNNNNNNNNNNNNNNNNNNNNNNNNNNNNNNNNNNNNNNNNNNNNNNNNNNNNNNNNNNN
NN NNNNNNNNNNNNNNNNNNNNNNNNNNNNNNNNNNNNNNNNNNNNNNNNNNNNNNNNNNNNNNNNNNNNNNNNNNNNNNNNNNNNNNNNNNNNNNNNN
NN NNNNNNNNNNNNNNNNNNNNNNNNNNNNNNNNNNNNNNNNNNNNNNNNNNNNNNNNNNNNNNNNNNNNNNNNNNNNNNNNNNNNNNNNNNNNNNNNN
NN NNNNNNNNNNNNNNNNNNNNNNNNNNNNNNNNNNNNNNNNNNNNNNNNNNN#NNNNN# NNNNNNNNNNNNNNNNNNNNNNNNNNNNNNNNNNNNNN
NN NNNNNNNNNNNNNNNNNNNNNNNNNNNNNNNNNNNNNNNNNNNNNNNNNN##NNNNN# NNNNNNNNNNNNNNNNNNNNNNNNNNNNNNNNNNNNNN
NN NNNNNNNNNNNNNNNNNNNNNNNNNNNNNNNNNNNNNNNNNNNNNNNNN#N#NNNNN# NNNNNNNNNNNNNNNNNNNNNNNNNNNNNNNNNNNNNN
NN NNNNNNNNNNNNNNNNNNNNNNNNNNNNNNNNNNNNNNNNNNNNNNNN#N###NNNN# NNNNNNNNNNNNNNNNNNNNNNNNNNNNNNNNNNNNNN
NN NNNNNNNNNNNNNNNNNNNNNNNNNNNNNNNNNNNNNNNNNNNNNNN#N####NNNN#  NNNNNNNNNNNNNNNNNNNNNNNNNNNNNNNNNNNNN
NN NNNNNNNNNNNNNNNNNNNNNNNNNNNNNNNNNNNNNNNNNNNNNN#NN#####NNNN# NNNNNNNNNNNNNNNNNNNNNNNNNNNNNNNNNNNNN
NN NNNNNNNNNNNNNNNNNNNNNNNNNNNNNNNNNNNNNNNNNNNNN#NNNN####NNN## NNNNNNNNNNNNNNNNNNNNNNNNNNNNNNNNNNNNN
NN NNNNNNNNNNNNNNNNNNNNNNNNNNNNNNNNNNNNNNNNNNNNN#N##NNN#NNNN#    NNNNNNNNNNNNNNNNNNNNNNNNNNNNNNNNNNN
NN NNNNNNNNNNNNNNNNNNNNNNNNNNNNNNNNNNNNNNN####N#NN##NNN#NNNN####   NNNNNNNNNNNNNNNNNNNNNNNNNNNNNNNNN
NN NNNNNNNNNNNNNNNNNNNNNNNNNNNNNNNNNNNNNN##NNN#NN###NNN#NNNN#NNN## NNNNNNNNNNNNNNNNNNNNNNNNNNNNNNNNN
NN NNNNNNNNNNNNNNNNNNNNNNNNNNNNNNNNNNNNN##N##N#N####NN##NNNN##NNN#  NNNNNNNNNNNNNNNNNNNNNNNNNNNNNNNN
NN NNNNNNNNNNNNNNNNNNNNNNNNNNNNN        $ #aa##N###N####NNNN###NN## NNNNNNNNNNNNNNNNNNNNNNNNNNNNNNNN
NN NNNNNNNNNNNNNNNNNNNNNNNNNNNNN        $ #aa###NN###NN#NNNN#N#NN#   NNNNNNNNNNNNNNNNNNNNNNNNNNNNNNN
NN NNNNNNNNNNNNNNNN############N        #GN##N###N#NNNN#NNNN#N##N### NNNNNNNNNNNNNNNNNNNNNNNNNNNNNNN
NN NNNNNNNNNNNNNNN#            b       gg##NN##NNNNN####NNNN#N##N### NNNNNNNNNNNNNNNNNNNNNNNNNNNNNNN
NN NNNNNNNNNNNNN##             b       g  #####NNNN#####NNNN#N#NN### NNNNNNNNNNNNNNNNNNNNNNNNNNNNNNN
NN NNNNNNNNNNN##     #########BNNNNNNNN#N      #NNN##N##NNN##N#N#### NNNNNNNNNNNNNNNNNNNNNNNNNNNNNNN
NN NNNNNNNN###      #NNNNNNNNNNNN       NNNNNN NN##NNN##NNN#N##N#### NNNNNNNNNNNNNNNNNNNNNNNNNNNNNNN
NN NNNNNNNN        ##NNNNNNNNNNNN ######  NNN  #NNNNNNNNNNN###N##N#  NNNNNNNNNNNNNNNNNNNNNNNNNNNNNNN
##@#######N       #NNNNNNNNNNNNN  #NNNNN#     #NNNNNN##NNN##NN##### NNNNNNNNNNNNNNNNNNNNNNNNNNNNNNNN
#N NNN#NN#N      ##NNNNNNNNNNNNN ##NNNN##  #####NNNN##NNNN#N###N### NNNNNNNNNNNNNNNNNNNNNNNNNNNNNNNN
##              ##NNNNNNNNNNNNNN #NNNN### ####NNNN###NNNN##NNN###N# NNNNNNNNNNNNNNNNNNNNNNNNNNNNNNNN
#N             ##NNNNNNNNNNNNNN  #N++N#####NN#NNNN##NNNNN#NN###NN## NNNNNNNNNNNNNNNNNNNNNNNNNNNNNNNN
#N            ###NNNNNNNNNNNNNN #N++NN####NNN#NNN##NNNNN#####N####  NNNNNNNNNNNNNNNNNNNNNNNNNNNNNNNN
#N     NNNN   NNNNNNNNNNNNNNNNN #N++N####NNNN#N####NNNNN#N# ###    NNNNNNNNNNNNNNNNNNNNNNNNNNNNNNNNN
#N1    N##N   NNNNNNNNNNNNNNNNN #N++N###NNNNN####NNNNNN####     NNNNNNNNNNNNNNNNNNNNNNNNNNNNNNNNNNNN
#NNNNN#N##N   NNNNNNNNNNNNNNNNN2#N++N####NN#####NNNNNN##    NNNNNNNNNNNNNNNNNNNNNNNNNNNNNNNNNNNNNNNN
##########N   NNNNNNNNNNNNNNNNN #N++NN#####NNNNN#NNNNN#  NNNNNNNNNNNNNNNNNNNNNNNNNNNNNNNNNNNNNNNNNNN
NNN#N#NNNNN   NNNNNNNNNNNNNNNNN #NN++N#####NNNNNNN#NN## NNNNNNNNNNNNNNNNNNNNNNNNNNNNNNNNNNNNNNNNNNNN
NN#N#NNNNNN   NNNNNNNNNNNNNNNNN  #NNNN### #NNNNNNN####  NNNNNNNNNNNNNNNNNNNNNNNNNNNNNNNNNNNNNNNNNNNN
NN#N#NNNNNN   NNNNNNNNNNNNNNNNNN #NNNNN## #NNNNNNN#    NNNNNNNNNNNNNNNNNNNNNNNNNNNNNNNNNNNNNNNNNNNNN
N#N#NNN""""   """"NNNNNNNNNNNNNN  #######  #NNNNN#####  NNNNNNNNNNNNNNNNNNNNNNNNNNNNNNNNNNNNNNNNNNNN
#N#NNNN"   +++   "NNNNNNNNNNNNNNN N        ###NN## NN##  NNNNNNNNNNNNNNNNNNNNNNNNNNNNNNNNNNNNNNNNNNN
N#NNNNN"  ++ ++  "NNNNNNNNNNNNNNN NNNNNNNN   ####  ##NN# NNNNNNNNNNNNNNNNNNNNNNNNNNNNNNNNNNNNNNNNNNN
#NNNNNN" ++   ++ "NNNNNNNNNNNNNNN NNNNNNNN      #N#aa#N# NNNNNNNNNNNNNNNNNNNNNNNNNNNNNNNNNNNNNNNNNNN
NNNNNNN" +     + "NNNNNNNNNNNN          NNNNNNN #N#aa#N# NNNNNNNNNNNNNNNNNNNNNNNNNNNNNNNNNNNNNNNNNNN
NNNNNNN"++"""""++"NNNNNNNNNNNN             NNNN #NN##NN# NNNNNNNNNNNNNNNNNNNNNNNNNNNNNNNNNNNNNNNNNNN
NNNNNNNN+NNN#NNN+NNNNNNNNNNNNN             NNN   ##NN##  NNNNNNNNNNNNNNNNNNNNNNNNNNNNNNNNNNNNNNNNNNN
NNNNNNN +       + NNNNNNNNNNNN             NNN N  ####  NNNNNNNNNNNNNNNNNNNNNNNNNNNNNNNNNNNNNNNNNNNN
NNNNNNNN+NNN+NNN+NNNNNNNNNNNNNNNN       N       N3  Q  NNNNNNNNNNNNNNNNNNNNNNNNNNNNNNNNNNNNNNNNNNNNN
NNNNNNNN+NNN+NNN+NNNNNNNNNNNNNNNN       N        NNNNNNNNNNNNNNNNNNNNNNNNNNNNNNNNNNNNNNNNNNNNNNNNNNN
NNNNNNNN+NNN+NNN+NNNNNNNNNNNNNNNN       N        #  NNNNNNNNNNNNNNNNNNNNNNNNNNNNNNNNNNNNNNNNNNNNNNNN
NNNNNNNN++NN+NN++NNNNNNNNNNNNNNNN    ###N        #NNNNNNNNNNNNNNNNNNNNNNNNNNNNNNNNNNNNNNNNNNNNNNNNNN
NNNNNNNNN++N+N++NNNNNNNNNNNNNNNNN     N N        #  NNNNNNNNNNNNNNNNNNNNNNNNNNNNNNNNNNNNNNNNNNNNNNNN
NNNNNNNNNN+N+N+NNNNNNNNNNNNNNNNNN     N N    ###    NNNNNNNNNNNNNNNNNNNNNNNNNNNNNNNNNNNNNNNNNNNNNNNN
NNNNNNNNN++N+N++NNNNNNNNNNNNNNNNN     N N     N     NNNNNNNNNNNNNNNNNNNNNNNNNNNNNNNNNNNNNNNNNNNNNNNN
NNNNNNNN++NN+NN++NNNNNNNNNNNNNNNN     N N     N     NNNNNNNNNNNNNNNNNNNNNNNNNNNNNNNNNNNNNNNNNNNNNNNN
NNNN+++++NNN+NNN+++++NNNNNNNNNNNN     N N     N     NNNNNNNNNNNNNNNNNNNNNNNNNNNNNNNNNNNNNNNNNNNNNNNN
NNN++NNN####+####NNN++NNNNNNNNNNN     N N     N     NNNNNNNNNNNNNNNNNNNNNNNNNNNNNNNNNNNNNNNNNNNNNNNN
NNN+NNN##       ##NNN+NNNNNNNNNNN     N N     N     NNNNNNNNNNNNNNNNNNNNNNNNNNNNNNNNNNNNNNNNNNNNNNNN
NNN+NNN#         #NNN+NNNNNNNNNNN####NNNN####NNNNNNNNNNNNNNNNNNNNNNNNNNNNNNNNNNNNNNNNNNNNNNNNNNNNNNN
NNN+NNN#         #NNN+NNNNNNNNNNNNNNNNNNNNNNNNNNNNNNNNNNNNNNNNNNNNNNNNNNNNNNNNNNNNNNNNNNNNNNNNNNNNNN
NNN+NNN#ii       #NNN+NNNNNNNNNNNNNNNNNNNNNNNNNNNNNNNNNNNNNNNNNNNNNNNNNNNNNNNNNNNNNNNNNNNNNNNNNNNNNN
NNN+NNN# i       #NNN+NNNNNNNNNNNNNNNNNNNNNNNNNNNNNNNNNNNNNNNNNNNNNNNNNNNNNNNNNNNNNNNNNNNNNNNNNNNNNN
NNN+NNN# i       #NNN+NNNNNNNNNNNNNNNNNNNNNNNNNNNNNNNNNNNNNNNNNNNNNNNNNNNNNNNNNNNNNNNNNNNNNNNNNNNNNN
N##+####BII##########+##NNNNNNNNNNNNNNNNNNNNNNNNNNNNNNNNNNNNNNNNNNNNNNNNNNNNNNNNNNNNNNNNNNNNNNNNNNNN
N#      #NNNNNNN#      #NNNNNNNNNNNNNNNNNNNNNNNNNNNNNNNNNNNNNNNNNNNNNNNNNNNNNNNNNNNNNNNNNNNNNNNNNNNN
N#      #NNNNNNN#      #NNNNNNNNNNNNNNNNNNNNNNNNNNNNNNNNNNNNNNNNNNNNNNNNNNNNNNNNNNNNNNNNNNNNNNNNNNNN
N#      #NNNNNNN#      #NNNNNNNNNNNNNNNNNNNNNNNNNNNNNNNNNNNNNNNNNNNNNNNNNNNNNNNNNNNNNNNNNNNNNNNNNNNN
N#      #NNNNNNN#      #NNNNNNNNNNNNNNNNNNNNNNNNNNNNNNNNNNNNNNNNNNNNNNNNNNNNNNNNNNNNNNNNNNNNNNNNNNNN
N#      #NNNNNNN#      #NNNNNNNNNNNNNNNNNNNNNNNNNNNNNNNNNNNNNNNNNNNNNNNNNNNNNNNNNNNNNNNNNNNNNNNNNNNN
N#>     #NNNNNNN#     <#NNNNNNNNNNNNNNNNNNNNNNNNNNNNNNNNNNNNNNNNNNNNNNNNNNNNNNNNNNNNNNNNNNNNNNNNNNNN
N########NNNNNNN########NNNNNNNNNNNNNNNNNNNNNNNNNNNNNNNNNNNNNNNNNNNNNNNNNNNNNNNNNNNNNNNNNNNNNNNNNNNN
NNNNNNNNNNNNNNNNNNNNNNNNNNNNNNNNNNNNNNNNNNNNNNNNNNNNNNNNNNNNNNNNNNNNNNNNNNNNNNNNNNNNNNNNNNNNNNNNNNNN
NNNNNNNNNNNNNNNNNNNNNNNNNNNNNNNNNNNNNNNNNNNNNNNNNNNNNNNNNNNNNNNNNNNNNNNNNNNNNNNNNNNNNNNNNNNNNNNNNNNN
NNNNNNNNNNNNNNNNNNNNNNNNNNNNNNNNNNNNNNNNNNNNNNNNNNNNNNNNNNNNNNNNNNNNNNNNNNNNNNNNNNNNNNNNNNNNNNNNNNNN
NNNNNNNNNNNNNNNNNNNNNNNNNNNNNNNNNNNNNNNNNNNNNNNNNNNNNNNNNNNNNNNNNNNNNNNNNNNNNNNNNNNNNNNNNNNNNNNNNNNN
message: Oh..it's you, you know I have to kill you
message1: You really shouldn't be in here. You don't know what you're doing.
message2: I know you want to kill me. But there's more then*Shocking Sound* AHhhhhhhahhhaahhaha.
message3: Look out!