name:Vertigo
NNNNNN#NNNNNNNNNNNNNNNNNNNNNNNNNNNNNNNNNN
N     +NNNNNNNNNNN
N      NNNNNNNNNN#$$$$$$$$$
N      NNNNNNNNNN#    b   $             #
N      NNNNNNNNNN#$$$k$$$ $NNNNND((((((
N      NNNNNNNNNNN  # $N$ $
#              $a$  # $N$ $
NNNNNN$"""""""ANNNNN# $NNDNNNNNNNNNNNNNNN
NNNNNN$NNNNNNNNNNNNN$ $NNNNNNNNNNNNNNNNNN
NNNNNN$NNNNNN&NNNNNN$ $NNbNNNNNNNNNNNNNNN
NNNNNN$NNNNNN=NNNNNN$B$NNKNNNNNNNNNNNNNNN
NNNNNN$NNNNNNhNNNNNNNNNNNNNNNNNNNNNNNNNNN
# @              abd   Q              #
NNNNNN$NNN+NN#NNNNNN   N              NNN
NNNNN# NNN+NNNNNNNNN"""N""""""""""""""NNN
NNNNNN NNN+       #NNNNNNNNNNNNNNNNNNNNNN
NNNNNN NNN+NNNNNHNNNNNNNNNNNNNNNNNNNNNNNN
NNNNNN NNN+NNNNNNNNNNNNNNNNNNNNNNNNNNNNNN
N#  $$    +   #NNNNiNNNNNNNNNNNNNNNNNNNNN
NN  NN+NNNNNINNNNNNJNNNNNNNNNNNNNNNNNNNNN
NN  NN NNNNNNNNNNNNNNNNNNNNNNNNNNNNNNNNNN
NN""NNjNNNNNNNNNNNNNNNNNNNNNNNNNNNNNNNNNN
NNNNNN NNNNNNNNNNNNNNNNNNNNNNNNNNNNNNNNNN
NNNNNN NNNNNNNNNNNNNNNNNNNNNNNNNNNNNNNNNN
NNNNNN NNNNNNNNNNNNNNNNNNNNNNNNNNNNNNNNNN
NNNNNN NNNNNNNNNNNNNNNNNNNNNNNNNNNNNNNNNN
NNNNNN NNNNNNNNNNNNNNNNNNNNNNNNNNNNNNNNNN
NNNNNN NNNNNNNNNNNNNNNNNNNNNNNNNNNNNNNNNN
NNNNNN NNNNNNNNNNNNNNNNNNNNNNNNNNNNNNNNNN
NNNNNN NNNNNNNNNNNNNNNNNNNNNNNNNNNNNNNNNN
NNNNNN NNNNNNNNNNNNNNNNNNNNNNNNNNNNNNNNNN
NNNNNN NNNNNNNNNNNNNNNNNNNNNNNNNNNNNNNNNN
NNNNNN NNNNNNNNNNNNNNNNNNNNNNNNNNNNNNNNNN
NNNNNN NNNNNNNNNNNNNNNNNNNNNNNNNNNNNNNNNN
NNNNNN NNNNNNNNNNNNNNNNNNNNNNNNNNNNNNNNNN
NNNNNN NNNNNNNNNNNNNNNNNNNNNNNNNNNNNNNNNN
NNNNNN NNNNNNNNNNNNNNNNNNNNNNNNNNNNNNNNNN
NNNNNN NNNNNNNNNNNNNNNNNNNNNNNNNNNNNNNNNN
NNNNNN NNNNNNNNNNNNNNNNNNNNNNNNNNNNNNNNNN
NNNNNN NNNNNNNNNNNNNNNNNNNNNNNNNNNNNNNNNN
NNNNNN NNNNNNNNNNNNNNNNNNNNNNNNNNNNNNNNNN
NNNNNN NNNNNNNNNNNNNNNNNNNNNNNNNNNNNNNNNN
NNNNNN NNNNNNNNNNNNNNNNNNNNNNNNNNNNNNNNNN
NNNNNN NNNNNNNNNNNNNNNNNNNNNNNNNNNNNNNNNN
NNNNNN NNNNNNNNNNNNNNNNNNNNNNNNNNNNNNNNNN
NNNNNN NNNNNNNNNNNNNNNNNNNNNNNNNNNNNNNNNN
NNNNNN NNNNNNNNNNNNNNNNNNNNNNNNNNNNNNNNNN
NNNNNN NNNNNNNNNNNNNNNNNNNNNNNNNNNNNNNN
NNNNNN#NNNNNNNNNNNNNNNNNNNNNNNNNNNNNNNNNN
