###################N
#       $#       # N
#$$$$$$ $#         N
#$      $#         N
#$ $$$$$$#         N
#$       #        ON
#$$$$g$$$#         N
#$Q 11N            N
#$$$$$N            N
#                @ N
#                N N
#                N N
#                N N
#                N ###
#                N g #
#$$$$$###########NG# #
#                    #
#     ################
#######
message1: You win... for now.
