NN<NN>NNN>NN<N
NNgNNgNNNgNNgN
1Ng Ng Ng Ng N
GNNANNANNANNAN
@    1a     QN