1N@  1     Q
GNNNNNggNNNN
NNNNNN  NNNN
NNNNNN  NNNN
NNNNNN  NNNN
NNNNNN  NNNN