N       ONNN
N=NNNNNNNNNN
N NNNNNNNNNN
&    NNNNNNN
=ONN NNNNNNN
&&   NNNNNNN
)&N NNNNNNNN
N&       NNN
N& NNNNN NNN
"& "NNNN   "
NNNNNNNNNNNN
N@         Q