NNNO       N
NNNNNNNNNN=N
NNNNNNNNNN N
NNNNNNN    &
NNNNNNN NN =
NNNNNNN   &&&&&&
NNNNNNNN N (((((
NNN        N
NNN NNNNN  N
"   NNNN"  "
NNNNNNNNNNNN
Q         @N