message:Divide by Two
NNNNNNNNNNNNNNNNNNNNN
NNNNNNN#N#NN#NNNNNNNN
NNNNNNN#N##N#NNNNNNNN
NNNNNNN#N#N##NNNNNNNN
N>NNN>N#N#NN#NNNNNNNN
N=NNN=NNNNNNNNNNNNNNN
N                 NNN
NNNNNNNNNNNNNNNNN &NN
NNNNNNNNNNNNNNNNN =NN
"                  "N
NNNNNNNNNNNNNNNNNNNNN
NN##NN#NN#N#####NNNNN
N#NN#N#NN#NNN#NNN@ QN
N#NN#N#NN#NNN#NNNNNNN
NN##NNN##NNNN#NNNNNNN
NNNNNNNNNNNNNNNNNNNNN