message:Elevator for Boulders
message1:Solution by Ratfink
NNNNNNNNNNNNNNNNNNNNNNNNNNN
NNNNNNNNNNNN##NN#NN#N#####N
NNNNNNNNNNN#NN#N#NN#NNN#NNN
NNNNNNNNNNN#NN#N#NN#NNN#NNN
NNNNNNNNN>NN##NNN##NNNN#NNN
NNNNNNNNN=NNNNNNNNNNNNNNNNN
NNNNNNNNNg               "N
NNNNNNNNNN$NNNNNNNNNNNNNNNN
NNNNNNNNNN$NNNNNNNNNNNNNNNN
NNNNNNNNNN$NNNNN@1QNNNNNNNN
NNN#N#NN#N$NNNNNNNNNNNNNNNN
NNN#N##N#N$NNNNNNNNNNNNNNNN
NNN#N#N##N$NNNNNNNNNNNNNNNN
N>N#N#NN#N$NNNNNNNNNNNNNNNN
N=NNNNNNNN$NNNNNNNNNNNNNNNN
N          NNNNNNNNNNNNNNNN
NNNNNNNNNN NNNNNNNNNNNNNNNN
NNNNNNNNN" NNNNNNNNNNNNNNNN
NNNNNNNNNNGNNNNNNNNNNNNNNNN
NNNNNNNNNNNNNNNNNNNNNNNNNNN