&N>NNNNNNNNNNN
=N=NNNN@QNNNNN
&>>NNNNNNNNNNN
)&NNNNNNNNNNNN
N>NNNNNNNNNNNN
N&          "N
N&NNNNNNNNNNNN
N&NNN       <N
N&NNN=NNNNNNNN
N&N   NNNNNNNN
N&N NNNNNNNNNN
"&  "NNNNNNNNN