message:Boulder Elevator and Divide by Two
message1:Solution by ivanq
+1NNNNNNNN>   &NN
+NNNNNNNNNNNN==NN
+NNNNNNNNNNN  & N
+NNNNNNNNNNN NN N
+NNNNNNNNNNN    N
+NNNNNNNNNNNNN  N
+NNNNNNNNNNNN%  %
+NNNNNNNNNNNNNN<N
+NNNNNNNNNNNNNN&N
+NNNNNNNNNNNNNN<N
+@NNNNNNNNNN&  &N
+NNNNNNNNNNN= N&N
+N>       N & %&N
+NNNNNNNN=N NNN&N
+NNNNNNNN      &N
+NNNNNNNNNN NN &N
+NNNNNNNNN%&N  &%
+NNNNNNNNNN&N NNN
+NNNNNNNNN%&    %
QNNNNNNNNNNNNNNNN