@NNNNNNNNN>   &NN
+NNNNNNNNNNNN==NN
+NNNNNNNNNNN  & N
+NNNNNNNNNNN NN N
+NNNNNNNNNNN    N
+NNNNNNNNNNNNN  N
+NNNNNNNNNNNN%  %
+NNNNNNNNNNNNNN<N
+NNNNNNNNNNNNNN&N
QNNNNNNNNNNNNNN<N