#+NNNNNNNNNNNNNNNNNNNNNNNNNNNNNNNNNNNNNN
#+NNNNNNNNNNNNNNNNNNNNNNNNNNNNNNN>   &NN
#+NNNNNNNNNNNNNNNNNNNNNNNNNNNNNNNNNN==NN
#+NNNNNNNNNNNNNNNNNNNNNNNNNNNNNNNNN a& N
#+NNNNNNNNNNNNNNNNNNNNNNNNNNNNNNNNN NN N
#+NNNNNNNNNNNNNNNNNNNNNNNN&&&&NNNNN  a<N
#+NNNNNNNNNNNNNNNNNNNNNNNN)))&NNNNNNNaaN
#+NNNNNN                   < &  NNNN% &%
#+NNNNNNNNNNNNNNNNNNNNNNNNNNNN  NNNNNN<N
#+NNNNNNNNNNNNNNNNNNNNNNNNNNN%  %NNNNNa&
#+NNNNNNNNNNNNNNNNNNNNNNNNNNNN(ANNNNNNa=
#+N                                    m
#+N NNNNNNNNNNNNNNNNNNNNNNNNNNNNNNNNNN (
#+N NNNNNNNNNNNN>   &NNNNNNNNNNNNNNNNN N
#+N NNNNNNNNNNNNNNN==NNNNNNNNNNNNNNNNN N
#+N NNNNNNNNNNNNNN a& NNNNNNNNNNNNNNNN N
#+N NNNNNNNNNNNNNN NN NNNNNNNNNNNNNNNN N
#+N NNNNNNNNNNNNNN  a<NNNNNNNNNNNNNNNN N
#+N NNNNNNNNNNNNNNNNaaNNNNNNNNNNNNNNNN N
#+N NNNNNNNNNNNNNNN% &%NNNNNNNNNNNNNNN N
#+N NNNNNNNNNNNNNNNNN<NNNNNNNNNNNNNNNN N
#+N NNNNNNNNNNNNNNNN&aNNNNNNNNNNNNNNNN N
#+N NNNNNNNNNNNNNNNN=aNNNNNNNNNNNNNNNN N
#+N      %Na>    NNNm   %NNNa>    NNNN N
#+NNNNNN=NN=NNNNNNNa) N=NNNN=NNNNNNNNN N
#+NNNNNN NNk     NNMN N    Nj     NNNN N
#+NNNNNN NN=NNNN NNNN NNNN N=NNNN NNNN N
#+NNNNNN NN  &   NNNN N    N  &   NNNN N
#+NNNNNN NNN =  NNNNN N NNNNN =  NNNNN N
#+NNNNNN NN% &   NNNN N    N% &   NNNN N
#+NNNNNN NNNNN   NNNN NNNN NNNN   NNNN N
#+NNNNNN         NNNN NNNN        NNNN N
#+@    NNNN      NNNN NNNNNN      NNNN N
#+NN   NNN%      NNNN NNNNN%      NNNN N
#+NNHNGNNNN(((N) NNNN NNNNNN(((N) NNNN N
#+NNhNgN    <aN  %NNN NNN    <aN  %NNN N
#+NNKNJNNNNNN=N (NNNN NNNNNNNN=N (NNNN N
#+NNNNNNNNNN%     NNN NNNNNNN%     NNN N
#+NNNNNNNNNNNNNN  NNN NNNNNNNNNNN  NNN N
#+NNNNNNNNNNNNN%  NNN NNNNNNNNNN%  NNN N
#+NNNNNNNNNNNNNN( NNN NNNNNNNNNNN( NNN N
#+NNNNNNNNNNNNNNN     NNNNNNNNNNNN     N
#+NNNNNNNNNNNNNNN=NN  NNNNNNNNNNNN=NN  N
#+NNNNNNNNNNNNNN% N% a%NNNNNNNNNNN N% a%
#+NNNNNNNNNNNNNNNlNNNNNNNNNNNNNNNN NNNNN
#+a           NNN              NNN     N
NNNNNNNNNNNNN+NNN     NBNNNNNN+NNN     Q
NNNNNNNNNNNNN+N+     NNbNNNNNN+N+     NN
NNNNNNNNNNNNN+N+NNNNNNNLNNNNNN+N+NNNNNNN
NNNNNNNNNNNNN+N+    +NNNNNNNNN+N+    +NN
NNNNNNNNNNNNN+NNNNNN+NNNNNNNNN+NNNNNN+NN
NNNNNNNNNNNN%+      +NNNNNNNN%+      +NN