message:NOR gate by ivanq
message1:The last level, by the way, was a NAND gate.
NNNNNNNNNNNNNNNNNNNNNNNNNNNNNNNNN     >    NNNNNNNNN
NNNNNNNNNNNNNNNNNNNNNNNNNNNNNNNNNNNNNNNNNN=NNNNNNNNN
                >   N     >              N NNNNNNNNN
NNNNNNNNNNNNNNNNNNN=NNNNNNNNNNNNNNNNNNNN=N NNNNNNNNN
NNNNNNNNNNNNNNNNNNN                      N NNNNNNNNN
NNNNNNNNNNNNNNNNNNNNNNNNNNNNNNNNNNNNNNNN N NNNNNNNNN
NNNNNNNNNNNNNNNNNNNNNNNNNNNNNNNNNNNNN""" " """""""""
NNNNNNNNNNNNNNNNNNNNNNNNNNNNNNNNNNNNN""N N N>    N""
NNNNNNNNNNNNNNNNNNNNNNNNNNNNNNNNNNNNN""N N N=NNNNN""
NNNNNNNNNNNNNNNNNNNNNNNNNNNNNNNNNNNNN""N N N  NNNN""
NNNNNNNNNNNNNNNNNNNNNNNNNNNNNNNNNNNNN""N N N& NNNN""
NNNNNNNNNNNNNNNNNNNNNNNNNNNNNN@1QNNNN""%    = NNNN""
NNNNNNNNNNNNNNNNNNNNNNNNNNNNNNNNNNNNN""NNNN=  %NNN""
NNNNNNNNNNNNNNNNNNNNNNNNNNNNNNNNNNNNN""NNN  &    N""
NNNNNNNNNNNNNNNNNNNNNNNNNNNNNNNNNNNNN""NNN NN&NN N""
NNNNNNNNNNNNNNNNNNNNNNNNNNNNNNNNNNNNN""NNN   &NN N""
NNNNNNNNNNNNNNNNNNNNNNNNNNNNNNNNNNNNN""NNNNN &NN N""
NNNNNNNNNNNNNNNNNNNNNNNNNNNNNNNNNNNNN""NNNN% &%N N""
NNNNNNNNNNNNNNNNNNNNNNNNNNNNNNNNNNNNN""NNNNNNNNN N""
NNNNNNNNNNNNNNNNNNNNNNNNNNNNNNNNNNNNN""""""""""" """
NNNNNNNNNNNNNNNNNNNNNNNNNNNNNNNNNNNNNNNNNNNNNNNN NNN
NNNNNNNNNNNNNNNNNNNNNNNNNNNNNNNNNNNNNNNNNNNNNNNN%NNN