name:Macintosh test
message:The sliding box at the lower right should strongly tend to move to the left if and only if you're running this on Mac OS X.
NNNNNNNNNNNNNNNNNNNNNNNNNNNNNNNNNNNNNNNNNNNNNNNNNNNNNNNNNNNNNNNNNNNNNNNNNNNNNNNNNNNNNNNNNNNNNNNNNNNNNNNNNNNNNNNNNNNNNNNNNNNNNNNNNNNNNNNNNNN
N                                                                                                                                         N
N+NNNNNNNNNNNNNNNNNNNNNNNNNNNNNNNNNNNNNNNNNNNNNNNNNNNNNNNNNNNNNNNNNNNNNNNNNNNNNNNNNNNNNNNNNNNNNNNNNNNNNNNNNNNNNNNNNNNNNNNNNNNNNNNNNNNNNNN+N
N+N>NNNNNNNNNNNNNNNNNNNNNNNNNNNNNNNNNNNNNNNNNNNNNNNNNNNNNNNNNNNNNNNNNNNNNNNNNNNNNNNNNNNNNNNNNNNNNNNNNNNNNNNNNNNNNNNNNNNNNNNNNNNNNNNNNNNNN+N
N+N=NNNNNNNNNNNNNNNNNNNNNNNNNNNNNNNNNNNNNNNNNNNNNNNNNNNNNNNNNNNNNNNNNNNNNNNNNNNNNNNNNNNNNNNNNNNNNNNNNNNNNNNNNNNNNNNNNNNNNNNNNNNNNNNNNNNNN+N
N+Ni>                                                                                                                             NN&N<NN+N
N+NNN=NN=========NNNNNNNNNNN=NN=======================================NNNNNNNNNNN=NN======================NNNNNNNNNNN=NNNNNNNNNNN NN=N=NN+N
N+NNN %N         NNNNNNNNNNN %N                                       NNNNNNNNNNN %N                      NNNNNNNNNNN %N          NNh iNN+N
N+NNN= N+++++++++NNNNNNNNNNN= N+++++++++++++++++++++++++++++++++++++++NNNNNNNNNNN= N++++++++++++++++++++++NNNNNNNNNNN= N NNNNNNNNNNNg NNN+N
N+NNN+ N+++++++++NNNNNNNNNNN+ N+++++++++++++++++++++++++++++++++++++++NNNNNNNNNNN+ N++++++++++++++++++++++NNNNNNNNNNN+ N          N%  %gN+N
N+NNN% N+++++++++NNNNNNNNNNN% N+++++++++++++++++++++++++++++++++++++++NNNNNNNNNNN% N++++++++++++++++++++++NNNNNNNNNNN% NNNNNNNNNN NNINNHN+N
N+NNNN N+++++++++NNNNNNNNNNNN N+++++++++++++++++++++++++++++++++++++++NNNNNNNNNNNN N++++++++++++++++++++++NNNNNNNNNNNN N          NNNNNNN+N
N+NNNN N+++++++++NNNNNNNNNNNN N+++++++++++++++++++++++++++++++++++++++NNNNNNNNNNNN N++++++++++++++++++++++NNNNNNNNNNNN N NNNNNNNNNNNNNNNN+N
N+NNNN N+++++++++NNNNNNNNNNNN N+++++++++++++++++++++++++++++++++++++++NNNNNNNNNNNN N++++++++++++++++++++++NNNNNNNNNNNN N          NNNNNNN+N
N+NNNN N+++++++++NNNNNNNNNNNN N+++++++++++++++++++++++++++++++++++++++NNNNNNNNNNNN N+++++++++++++++++++++ NNNNNNNNNNNN NNNNNNNNNN NNNNNNN+N
N+NNNN N+++++++++NNNNNNNNNNNN N+++++++++++++++++++++++++++++++++++++++NNNNNNNNNNNN N+++++++++++++++++++++ NNNNNNNNNNNN N>   &NNNN NNNNNNN+N
N+NNNN N+++++++++NNNNNNNNNNNN N+++++++++++++++++++++++++++++++++++++++NNNNNNNNNNNN N+++++++++++++++++++++ NNNNNNNNNNNN NNNN==NNNN NNNNNNN+N
N+NNNN N+++++++++NNNNNNNNNNNN N+++++++++++++++++++++++++++++++++++++++NNNNNNNNNNNN N+++++++++++++++++++++ NNNNNNN      NNN    NNN NNNNNNN+N
N+NNNN N+++++++++NNNNNNNNNNNN N+++++++++++++++++++++++++++++++++++++++NNNNNNNNNNNN N+++++++++++++++++++++ NNNNNNN NNNNNNNN NN NNN NNNNNNN+N
N+NNNN N+++++++++NNNNNNNNNNNN N++++++++++++++++++++++++++++++++++++++ NNNNNNNNNNNN N+++++++++++++++++++++ NNNNNNN      NNN    NNN NNNNNNN+N
N+NNNN N+++++++++NNNNNNNNNNNN N++++++++++++++++++++++++++++++++++++++ NNNNNNNNNNNN N+++++++++++++++++++++ NNNNNNNNNNNN NNNNN  NNN NNNNNNN+N
N+NNNN N+++++++++NNNNNNNNNNNN N++++++++++++++++++++++++++++++++++++++ NNNNNNN      N+++++++++++++++++++++ NNNNNNN      NNNN%  % i NNNNNNN+N
N+NNNN N++++++++ NNNNNNNNNNNN N++++++++++++++++++++++++++++++++++++++ NNNNNNN NNNNNN+++++++++++++++++++++ NNNNNNN NNNNNNNNNNN N NGNNNNNNN+N
N+NNNN N++++++++ NNNNNNNNNNNN N++++++++++++++++++++++++++++++++++++++ NNNNNNN      N+++++++++++++++++++++ NNNNNNN      NNNNNN N NNNNNNNNN+N
N+NNNN N++++++++ NNNNNNNNNNNN N++++++++++++++++++++++++++++++++++++++ NNNNNNNNNNNN N+++++++++++++++++++++ NNNNNNNNNNNN NNNNNN N NNNNNNNNN+N
N+NNNN N++++++++ NNNNNNN      N++++++++++++++++++++++++++++++++++++++ NNNNNNN      N+++++++++++++++++++++ NNNNNNN      NNN&   N NNNNNNNNN+N
N+NNNN N++++++++ NNNNNNN NNNNNN++++++++++++++++++++++++++++++++++++++ NNNNNNN NNNNNN+++++++++++++++++++++ NNNNNNN NNNNNNNN= N % NNNNNNNNN+N
N+NNNN N++++++++ NNNNNNN      N++++++++++++++++++++++++++++++++++++++ NNNNNNN      N+++++++++++++++++++++ NNNNNNN      NN   % % NNNNNNNNN+N
N+NNNN N%%%%%%%%%NNNNNNNNNNNN N%%%%%%%%%%%%%%%%%%%%%%%%%%%%%%%%%%%%%%%NNNNNNNNNNNN N%%%%%%%%%%%%%%%%%%%%%%NNNNNNNNNNNN NN NNN % NNNNNNNNN+N
N+NNNN                                                                                                                        % NNNNNNNNN+N
N+NNNNNNNNNNNNNNNNNNNNNNNNNNNNNNNNNNNNNNNNNNNNNNNNNNNNNNNNNNNNNNNNNNNNNNNNNNNNNNNNNNNNNNNNNNNNNNNNNNNNNNNNNNNNNNNNNNNNNNN iN  % NNNNNNNNN+N
N+                                                                                                    @NNNNNNNNNNNNNNNNN% i   % NNNNNNNNN+N
NNNNNNNNNNNNNNNNNNNNNNNNNNNNNNNNNNNNNNNNNNNNNNNNNNNNNNNNNNNNNNNNNNNNNNNNNNNNNNNNNNNNNNNNNNNNNNNNNNNNNN+NNNNNNNNNNNNNNNNNN&i NNN NNNNNNNNN+N
NNNNNNNNNNNNNNNNNNNNNNNNNNNNNNNNNNNNNNNNNNNNNNNNNNNNNNNNNNNNNNNNNNNNNNNNNNNNNNNNNNNNNNNNNNNNNNNNNNNNNN+NNNNNNNNNNNNNNNNN%&  %NN NNNNNNNNN+N
NNNNNNNNNNNNNNNNNNNNNNNNNNNNNNNNNNNNNNNNNNNNNNNNNNNNNNNNNNNNNNNNNNNNNNNNNNNNNNNNNNNNNNNNNNNNNNNNNNNNNN+NNNNNNNNNNNNNNNNNNNi&NNN NNNNNNNNN+N
NNNNNNNNNNNNNNNNNNNNNNNNNNNNNNNNNNNNNNNNNNNNNNNNNNNNNNNNNNNNNNNNNNNNNNNNNNNNNNNNNNNNNNNNNNNNNNNNNNNNNN+NNNNNNNNNNNNNNNNNNN =NNN NNNNNNNNN+N
NNNNNNNNNNNNNNNNNNNNNNNNNNNNNNNNNNNNNNNNNNNNNNNNNNNNNNNNNNNNNNNNNNNNNNNNNNNNNNNNNNNNNNNNNNNNNNNNNNNNNN+NNNNNNNNNNNNNNNNNN%   NN NNNNNNNNN+N
NNNNNNNNNNNNNNNNNNNNNNNNNNNNNNNNNNNNNNNNNNNNNNNNNNNNNNNNNNNNNNNNNNNNNNNNNNNNNNNNNNNNNNNNNNNNNNNNNNNNNN+NNNNNNNNNNNNNNNNNNNNN NN NNNNNNNNN+N
NNNNNNNNNNNNNNNNNNNNNNNNNNNNNNNNNNNNNNNNNNNNNNNNNNNNNNNNNNNNNNNNNNNNNNNNNNNNNNNNNNNNNNNNNNNNNNNNNNNNNN+NNNNNNNNNNNNNNNNNNNN      NNNNNNNN+N
NNNNNNNNNNNNNNNNNNNNNNNNNNNNNNNNNNNNNNNNNNNNNNNNNNNNNNNNNNNNNNNNNNNNNNNNNNNNNNNNNNNNNNNNNNNNNNNNNNNNNN+NNNNNNNNNNNNNNNNNNNN NNNN NNNNNNNN+N
NNNNNNNNNNNNNNNNNNNNNNNNNNNNNNNNNNNNNNNNNNNNNNNNNNNNNNNNNNNNNNNNNNNNNNNNNNNNNNNNNNNNNNNNNNNNNNNNNNNNNN+N                    %NNN NNNNNNNN+N
NNNNNNNNNNNNNNNNNNNNNNNNNNNNNNNNNNNNNNNNNNNNNNNNNNNNNNNNNNNNNNNNNNNNNNNNNNNNNNNNNNNNNNNNNNNNNNNNNNNNNN+N NNNNNNNNNNNNNNNNNN)NNNN NNNNNNNN+N
NNNNNNNNNNNNNNNNNNNNNNNNNNNNNNNNNNNNNNNNNNNNNNNNNNNNNNNNNNNNNNNNNNNNNNNNNNNNNNNNNNNNNNNNNNNNNNNNNNNNNN+N  NNNNNNNNNNNNNNNNNNNNN  NNNNNNNN+N
NNNNNNNNNNNNNNNNNNNNNNNNNNNNNNNNNNNNNNNNNNNNNNNNNNNNNNNNNNNNNNNNNNNNNNNNNNNNNNNNNNNNNNNNNNNNNNNNNNNNNN+NN NNNNNNNNNNNNNNNNNNNNN NNNNNNNNN+N
NNNNNNNNNNNNNNNNNNNNNNNNNNNNNNNNNNNNNNNNNNNNNNNNNNNNNNNNNNNNNNNNNNNNNNNNNNNNNNNNNNNNNNNNNNNNNNNNNNNNNN+N%           &           %NNNNNNNN+N
NNNNNNNNNNNNNNNNNNNNNNNNNNNNNNNNNNNNNNNNNNNNNNNNNNNNNNNNNNNNNNNNNNNNNNNNNNNNNNNNNNNNNNNNNNNNNNNNNNNNNN+NNNNNNNNNNNNNNNNNNNNNNNNNNNNNNNNNN+N
NNNNNNNNNNNNNNNNNNNNNNNNNNNNNNNNNNNNNNNNNNNNNNNNNNNNNNNNNNNNNNNNNNNNNNNNNNNNNNNNNNNNNNNNNNNNNNNNNNNNNN+                                  +N
NNNNNNNNNNNNNNNNNNNNNNNNNNNNNNNNNNNNNNNNNNNNNNNNNNNNNNNNNNNNNNNNNNNNNNNNNNNNNNNNNNNNNNNNNNNNNNNNNNNNNNNNNNNNNNNNNNNNNNNNNNNNNNNNNNNNNNNNNNN
