name:Windows test
message:The sliding box at the lower right should strongly tend to move to the left if and only if you're running this on Windows.
NNNNNNNNNNNNNNNNNNNNNNNNNNNNNNNNNNNNNNNNNNNNNNNNNNNNNNNNNNNNNNNNNNNNNNNNNNNNNNNNNNNNNNNNNNNNNNNNNNNNNNNNNNNNNNNNNN
N                                                                                                                N
N+NNNNNNNNNNNNNNNNNNNNNNNNNNNNNNNNNNNNNNNNNNNNNNNNNNNNNNNNNNNNNNNNNNNNNNNNNNNNNNNNNNNNNNNNNNNNNNNNNNNNNNNNNNNNNN+N
N+N>NNNNNNNNNNNNNNNNNNNNNNNNNNNNNNNNNNNNNNNNNNNNNNNNNNNNNNNNNNNNNNNNNNNNNNNNNNNNNNNNNNNNNNNNNNNNNNNNNNNNNNNNNNNN+N
N+N=NNNNNNNNNNNNNNNNNNNNNNNNNNNNNNNNNNNNNNNNNNNNNNNNNNNNNNNNNNNNNNNNNNNNNNNNNNNNNNNNNNNNNNNNNNNNNNNNNNNNNNNNNNNN+N
N+Ni>                                                                                                    NN&N<NN+N
N+NNN=NN========================NNNNNNNNNNN=NN=====NNNNNNNNNNN=NN================NNNNNNNNNNN=NNNNNNNNNNN NN=N=NN+N
N+NNN %N                        NNNNNNNNNNN %N     NNNNNNNNNNN %N                NNNNNNNNNNN %N          NNh iNN+N
N+NNN= N++++++++++++++++++++++++NNNNNNNNNNN= N+++++NNNNNNNNNNN= N++++++++++++++++NNNNNNNNNNN= N NNNNNNNNNNNg NNN+N
N+NNN+ N++++++++++++++++++++++++NNNNNNNNNNN+ N++++ NNNNNNNNNNN+ N++++++++++++++++NNNNNNNNNNN+ N          N%  %gN+N
N+NNN% N++++++++++++++++++++++++NNNNNNNNNNN% N++++ NNNNNNNNNNN% N++++++++++++++++NNNNNNNNNNN% NNNNNNNNNN NNINNHN+N
N+NNNN N++++++++++++++++++++++++NNNNNNNNNNNN N++++ NNNNNNNNNNNN N++++++++++++++++NNNNNNNNNNNN N          NNNNNNN+N
N+NNNN N++++++++++++++++++++++++NNNNNNNNNNNN N++++ NNNNNNNNNNNN N+++++++++++++++ NNNNNNNNNNNN N NNNNNNNNNNNNNNNN+N
N+NNNN N++++++++++++++++++++++++NNNNNNNNNNNN N++++ NNNNNNNNNNNN N+++++++++++++++ NNNNNNNNNNNN N          NNNNNNN+N
N+NNNN N++++++++++++++++++++++++NNNNNNNNNNNN N++++ NNNNNNNNNNNN N+++++++++++++++ NNNNNNNNNNNN NNNNNNNNNN NNNNNNN+N
N+NNNN N++++++++++++++++++++++++NNNNNNNNNNNN N++++ NNNNNNNNNNNN N+++++++++++++++ NNNNNNNNNNNN N>   &NNNN NNNNNNN+N
N+NNNN N++++++++++++++++++++++++NNNNNNNNNNNN N++++ NNNNNNNNNNNN N+++++++++++++++ NNNNNNNNNNNN NNNN==NNNN NNNNNNN+N
N+NNNN N++++++++++++++++++++++++NNNNNNNNNNNN N++++ NNNNNNNNNNNN N+++++++++++++++ NNNNNNN      NNN    NNN NNNNNNN+N
N+NNNN N++++++++++++++++++++++++NNNNNNNNNNNN N++++ NNNNNNNNNNNN N+++++++++++++++ NNNNNNN NNNNNNNN NN NNN NNNNNNN+N
N+NNNN N++++++++++++++++++++++++NNNNNNNNNNNN N++++ NNNNNNNNNNNN N+++++++++++++++ NNNNNNN      NNN    NNN NNNNNNN+N
N+NNNN N++++++++++++++++++++++++NNNNNNNNNNNN N++++ NNNNNNNNNNNN N+++++++++++++++ NNNNNNNNNNNN NNNNN  NNN NNNNNNN+N
N+NNNN N++++++++++++++++++++++++NNNNNNNNNNNN N++++ NNNNNNN      N+++++++++++++++ NNNNNNN      NNNN%  % i NNNNNNN+N
N+NNNN N++++++++++++++++++++++++NNNNNNNNNNNN N++++ NNNNNNN NNNNNN+++++++++++++++ NNNNNNN NNNNNNNNNNN N NGNNNNNNN+N
N+NNNN N++++++++++++++++++++++++NNNNNNNNNNNN N++++ NNNNNNN      N+++++++++++++++ NNNNNNN      NNNNNN N NNNNNNNNN+N
N+NNNN N+++++++++++++++++++++++ NNNNNNNNNNNN N++++ NNNNNNNNNNNN N+++++++++++++++ NNNNNNNNNNNN NNNNNN N NNNNNNNNN+N
N+NNNN N+++++++++++++++++++++++ NNNNNNN      N++++ NNNNNNN      N+++++++++++++++ NNNNNNN      NNN&   N NNNNNNNNN+N
N+NNNN N+++++++++++++++++++++++ NNNNNNN NNNNNN++++ NNNNNNN NNNNNN+++++++++++++++ NNNNNNN NNNNNNNN= N % NNNNNNNNN+N
N+NNNN N+++++++++++++++++++++++ NNNNNNN      N++++ NNNNNNN      N+++++++++++++++ NNNNNNN      NN   % % NNNNNNNNN+N
N+NNNN N%%%%%%%%%%%%%%%%%%%%%%%%NNNNNNNNNNNN N%%%%%NNNNNNNNNNNN N%%%%%%%%%%%%%%%%NNNNNNNNNNNN NN NNN % NNNNNNNNN+N
N+NNNN                                                                                               % NNNNNNNNN+N
N+NNNNNNNNNNNNNNNNNNNNNNNNNNNNNNNNNNNNNNNNNNNNNNNNNNNNNNNNNNNNNNNNNNNNNNNNNNNNNNNNNNNNNNNNNNNNNN iN  % NNNNNNNNN+N
N+                                                                           @NNNNNNNNNNNNNNNNN% i   % NNNNNNNNN+N
NNNNNNNNNNNNNNNNNNNNNNNNNNNNNNNNNNNNNNNNNNNNNNNNNNNNNNNNNNNNNNNNNNNNNNNNNNNNN+NNNNNNNNNNNNNNNNNN&i NNN NNNNNNNNN+N
NNNNNNNNNNNNNNNNNNNNNNNNNNNNNNNNNNNNNNNNNNNNNNNNNNNNNNNNNNNNNNNNNNNNNNNNNNNNN+NNNNNNNNNNNNNNNNN%&  %NN NNNNNNNNN+N
NNNNNNNNNNNNNNNNNNNNNNNNNNNNNNNNNNNNNNNNNNNNNNNNNNNNNNNNNNNNNNNNNNNNNNNNNNNNN+NNNNNNNNNNNNNNNNNNNi&NNN NNNNNNNNN+N
NNNNNNNNNNNNNNNNNNNNNNNNNNNNNNNNNNNNNNNNNNNNNNNNNNNNNNNNNNNNNNNNNNNNNNNNNNNNN+NNNNNNNNNNNNNNNNNNN =NNN NNNNNNNNN+N
NNNNNNNNNNNNNNNNNNNNNNNNNNNNNNNNNNNNNNNNNNNNNNNNNNNNNNNNNNNNNNNNNNNNNNNNNNNNN+NNNNNNNNNNNNNNNNNN%   NN NNNNNNNNN+N
NNNNNNNNNNNNNNNNNNNNNNNNNNNNNNNNNNNNNNNNNNNNNNNNNNNNNNNNNNNNNNNNNNNNNNNNNNNNN+NNNNNNNNNNNNNNNNNNNNN NN NNNNNNNNN+N
NNNNNNNNNNNNNNNNNNNNNNNNNNNNNNNNNNNNNNNNNNNNNNNNNNNNNNNNNNNNNNNNNNNNNNNNNNNNN+NNNNNNNNNNNNNNNNNNNN      NNNNNNNN+N
NNNNNNNNNNNNNNNNNNNNNNNNNNNNNNNNNNNNNNNNNNNNNNNNNNNNNNNNNNNNNNNNNNNNNNNNNNNNN+NNNNNNNNNNNNNNNNNNNN NNNN NNNNNNNN+N
NNNNNNNNNNNNNNNNNNNNNNNNNNNNNNNNNNNNNNNNNNNNNNNNNNNNNNNNNNNNNNNNNNNNNNNNNNNNN+N                    %NNN NNNNNNNN+N
NNNNNNNNNNNNNNNNNNNNNNNNNNNNNNNNNNNNNNNNNNNNNNNNNNNNNNNNNNNNNNNNNNNNNNNNNNNNN+N NNNNNNNNNNNNNNNNNN)NNNN NNNNNNNN+N
NNNNNNNNNNNNNNNNNNNNNNNNNNNNNNNNNNNNNNNNNNNNNNNNNNNNNNNNNNNNNNNNNNNNNNNNNNNNN+N  NNNNNNNNNNNNNNNNNNNNN  NNNNNNNN+N
NNNNNNNNNNNNNNNNNNNNNNNNNNNNNNNNNNNNNNNNNNNNNNNNNNNNNNNNNNNNNNNNNNNNNNNNNNNNN+NN NNNNNNNNNNNNNNNNNNNNN NNNNNNNNN+N
NNNNNNNNNNNNNNNNNNNNNNNNNNNNNNNNNNNNNNNNNNNNNNNNNNNNNNNNNNNNNNNNNNNNNNNNNNNNN+N%           &           %NNNNNNNN+N
NNNNNNNNNNNNNNNNNNNNNNNNNNNNNNNNNNNNNNNNNNNNNNNNNNNNNNNNNNNNNNNNNNNNNNNNNNNNN+NNNNNNNNNNNNNNNNNNNNNNNNNNNNNNNNNN+N
NNNNNNNNNNNNNNNNNNNNNNNNNNNNNNNNNNNNNNNNNNNNNNNNNNNNNNNNNNNNNNNNNNNNNNNNNNNNN+                                  +N
NNNNNNNNNNNNNNNNNNNNNNNNNNNNNNNNNNNNNNNNNNNNNNNNNNNNNNNNNNNNNNNNNNNNNNNNNNNNNNNNNNNNNNNNNNNNNNNNNNNNNNNNNNNNNNNNNN
