name:Linux test
message:The sliding box at the lower right should strongly tend to move to the left if and only if you're running this on Linux.
NNNNNNNNNNNNNNNNNNNNNNNNNNNNNNNNNNNNNNNNNNNNNNNNNNNNNNNNNNNNNNNNNNNNNNNNN
N                                                                       N
N+NNNNNNNNNNNNNNNNNNNNNNNNNNNNNNNNNNNNNNNNNNNNNNNNNNNNNNNNNNNNNNNNNNNNN+N
N+N>NNNNNNNNNNNNNNNNNNNNNNNNNNNNNNNNNNNNNNNNNNNNNNNNNNNNNNNNNNNNNNNNNNN+N
N+N=NNNNNNNNNNNNNNNNNNNNNNNNNNNNNNNNNNNNNNNNNNNNNNNNNNNNNNNNNNNNNNNNNNN+N
N+Ni>                                                           NN&N<NN+N
N+NNN=NN=NNNNNNNNNNN=NN==NNNNNNNNNNN=NN=NNNNNNNNNNN=NNNNNNNNNNN NN=N=NN+N
N+NNN %N NNNNNNNNNNN %N  NNNNNNNNNNN %N NNNNNNNNNNN %N          NNh iNN+N
N+NNN= N+NNNNNNNNNNN= N++NNNNNNNNNNN= N+NNNNNNNNNNN= N NNNNNNNNNNNg NNN+N
N+NNN+ N+NNNNNNNNNNN+ N++NNNNNNNNNNN+ N+NNNNNNNNNNN+ N          N%  %gN+N
N+NNN% N NNNNNNNNNNN% N++NNNNNNNNNNN% N+NNNNNNNNNNN% NNNNNNNNNN NNINNHN+N
N+NNNN N NNNNNNNNNNNN N++NNNNNNNNNNNN N+NNNNNNNNNNNN N          NNNNNNN+N
N+NNNN N NNNNNNNNNNNN N+ NNNNNNNNNNNN N+NNNNNNNNNNNN N NNNNNNNNNNNNNNNN+N
N+NNNN N NNNNNNNNNNNN N+ NNNNNNNNNNNN N NNNNNNNNNNNN N          NNNNNNN+N
N+NNNN N NNNNNNNNNNNN N+ NNNNNNNNNNNN N NNNNNNNNNNNN NNNNNNNNNN NNNNNNN+N
N+NNNN N NNNNNNNNNNNN N+ NNNNNNNNNNNN N NNNNNNNNNNNN N>   &NNNN NNNNNNN+N
N+NNNN N NNNNNNNNNNNN N+ NNNNNNNNNNNN N NNNNNNNNNNNN NNNN==NNNN NNNNNNN+N
N+NNNN N NNNNNNNNNNNN N+ NNNNNNNNNNNN N NNNNNNN      NNN    NNN NNNNNNN+N
N+NNNN N NNNNNNNNNNNN N+ NNNNNNNNNNNN N NNNNNNN NNNNNNNN NN NNN NNNNNNN+N
N+NNNN N NNNNNNNNNNNN N+ NNNNNNNNNNNN N NNNNNNN      NNN    NNN NNNNNNN+N
N+NNNN N NNNNNNNNNNNN N+ NNNNNNNNNNNN N NNNNNNNNNNNN NNNNN  NNN NNNNNNN+N
N+NNNN N NNNNNNNNNNNN N+ NNNNNNN      N NNNNNNN      NNNN%  % i NNNNNNN+N
N+NNNN N NNNNNNNNNNNN N+ NNNNNNN NNNNNN NNNNNNN NNNNNNNNNNN N NGNNNNNNN+N
N+NNNN N NNNNNNNNNNNN N+ NNNNNNN      N NNNNNNN      NNNNNN N NNNNNNNNN+N
N+NNNN N NNNNNNNNNNNN N+ NNNNNNNNNNNN N NNNNNNNNNNNN NNNNNN N NNNNNNNNN+N
N+NNNN N NNNNNNN      N+ NNNNNNN      N NNNNNNN      NNN&   N NNNNNNNNN+N
N+NNNN N NNNNNNN NNNNNN+ NNNNNNN NNNNNN NNNNNNN NNNNNNNN= N % NNNNNNNNN+N
N+NNNN N NNNNNNN      N+ NNNNNNN      N NNNNNNN      NN   % % NNNNNNNNN+N
N+NNNN N%NNNNNNNNNNNN N%%NNNNNNNNNNNN N%NNNNNNNNNNNN NN NNN % NNNNNNNNN+N
N+NNNN                                                      % NNNNNNNNN+N
N+NNNNNNNNNNNNNNNNNNNNNNNNNNNNNNNNNNNNNNNNNNNNNNNNNNNNN iN  % NNNNNNNNN+N
N+                                  @NNNNNNNNNNNNNNNNN% i   % NNNNNNNNN+N
NNNNNNNNNNNNNNNNNNNNNNNNNNNNNNNNNNNN+NNNNNNNNNNNNNNNNNN&i NNN NNNNNNNNN+N
NNNNNNNNNNNNNNNNNNNNNNNNNNNNNNNNNNNN+NNNNNNNNNNNNNNNNN%&  %NN NNNNNNNNN+N
NNNNNNNNNNNNNNNNNNNNNNNNNNNNNNNNNNNN+NNNNNNNNNNNNNNNNNNNi&NNN NNNNNNNNN+N
NNNNNNNNNNNNNNNNNNNNNNNNNNNNNNNNNNNN+NNNNNNNNNNNNNNNNNNN =NNN NNNNNNNNN+N
NNNNNNNNNNNNNNNNNNNNNNNNNNNNNNNNNNNN+NNNNNNNNNNNNNNNNNN%   NN NNNNNNNNN+N
NNNNNNNNNNNNNNNNNNNNNNNNNNNNNNNNNNNN+NNNNNNNNNNNNNNNNNNNNN NN NNNNNNNNN+N
NNNNNNNNNNNNNNNNNNNNNNNNNNNNNNNNNNNN+NNNNNNNNNNNNNNNNNNNN      NNNNNNNN+N
NNNNNNNNNNNNNNNNNNNNNNNNNNNNNNNNNNNN+NNNNNNNNNNNNNNNNNNNN NNNN NNNNNNNN+N
NNNNNNNNNNNNNNNNNNNNNNNNNNNNNNNNNNNN+N                    %NNN NNNNNNNN+N
NNNNNNNNNNNNNNNNNNNNNNNNNNNNNNNNNNNN+N NNNNNNNNNNNNNNNNNN)NNNN NNNNNNNN+N
NNNNNNNNNNNNNNNNNNNNNNNNNNNNNNNNNNNN+N  NNNNNNNNNNNNNNNNNNNNN  NNNNNNNN+N
NNNNNNNNNNNNNNNNNNNNNNNNNNNNNNNNNNNN+NN NNNNNNNNNNNNNNNNNNNNN NNNNNNNNN+N
NNNNNNNNNNNNNNNNNNNNNNNNNNNNNNNNNNNN+N%           &           %NNNNNNNN+N
NNNNNNNNNNNNNNNNNNNNNNNNNNNNNNNNNNNN+NNNNNNNNNNNNNNNNNNNNNNNNNNNNNNNNNN+N
NNNNNNNNNNNNNNNNNNNNNNNNNNNNNNNNNNNN+                                  +N
NNNNNNNNNNNNNNNNNNNNNNNNNNNNNNNNNNNNNNNNNNNNNNNNNNNNNNNNNNNNNNNNNNNNNNNNN
