music:default
name:NNNNNNNN
message:Horrible maze tiem nao.
NNNNNNNNNNNNNNNNNNNNNNNNNNNNNNNNNNNNNNNNNNNNNNNNNNNNNNNNNNNNNNNNNNNNNNNNNNNNNNNN
NNNNNNNNNN###NNNNNNNNNNNNNNNNNNNNNNNNNNNNNNNNNNNNNNNNNNNNNNNNNNNNNNNNNNNNNNNNNNN
NNNNNNNNNN   $                                                                                                                                        
NNNNNNNNNN @ NNNNNNNNNNNNNNNNNNNNNNNNNNNNNNNNNNNNNNNNNNNNNNNNNNNNNNNNNNNNNNNNNNN
NNNNNNNNNN   NNNNNNNNNNNNNNNNNNNNNNNNNNNNNNNNNNNNNNNNNNNNNNNNNNNNNNNNNNNNNNNNNNN
NNNNNNNNNNOOO$   #NNNNNNNONN#NNNNNNNNNN   NNNNNNNNNNNN  NNNNNNNNNNNNNNNNNNNNNNNN
NNNNNNNNNN   NNN NNOOOONN=NN NNNNNNNNN     NNNNNNNNN      NNNNNNNNNNNNNNNNNNNNNN
NNNNNNNNNN   NNN NN====NN NN NNNNNNNN       NNNNNN          NNNNNNNNNNNNNNNNNNNN
NNNNNNNNNN   NNN1NN    NN NN      2                                $QNNNNNNNNNNN
NNNNNNNNNN   #N#          #N NNNNNN+N       N+NNNN          NNNNNN NNNNNNNNNNNNN
NNNNNNNNNN   #NNNNN    NN NN N###NN+N       N+NNNN          NNNNNN $QNNNNNNNNNNN
NNNNNNNNNN   #NNNNN    NN NN N   #N+N###    N+  NN          NNNNNN NNNNNNNNNNNNN
NNNNNNNNNN  NNNNNNN""""NN NN     #N+N N     NNN+NN          NNNNNN $QNNNNNNNNNNN
NNNNNNNNNN   NNNNNNNNNNNN NN#N   #N+N N     NNN+NN###       NNNNNN NNNNNNNNNNNNN
NNNNNNNNNN   NNNNNNNNNNNN NNNN   #N+N N     NNN+NN N        NNNNNN $QNNNNNNNNNNN
NNNNNNNNNN   NNNNNNNNNNNN        NN+N N     NNN+NN N        NNNNNN NNNNNNNNNNNNN
NNNNNNNNNN   NNNNNNNNNNNN NNNNNNNNN+  +     NNN+NN N        NNNNNN  QNNNNNNNNNNN
NNNNNNNNNN"""NNNNNNNNNNNN NNNNNNNNNNNNNNN###NNN+   +        NNNNNN NNNNNNNNNNNNN
NNNNNNNNNNNNNNNNNNNNNNNNN"NNNNNNNNNNNNNNNNNNNNNNNNNNNNNN###NNNNNNN3$QNNNNNNNNNNN
NNNNNNNNNNNNNNNNNNNNNNNNNNNNNNNNNNNNNNNNNNNNNNNNNNNNNNNNNNNNNNNNNN NNNNNNNNNNNNN
NNNNNNNNNNNNNNNNNNNNNNNNNNNNNNNNNNNNNNNNNNNNNNNNNNNNNNNNNNNNNNNNNN $QNNNNNNNNNNN
NNNNNNNNNNNNNNNNNNNNNNNNNNNNNNNNNNNNNNNNNNNNNNNNNNNNNNNNNNNNNNNNNN NNNNNNNNNNNNN
NNNNNNNNNNNNNNNNNNNNNNNNNNNNNNNNNNNNNNNNNNNNNNNNNNNNNNNNNNNNNNNNNN $QNNNNNNNNNNN
NNNNNNNNNNNNNNNNNNNNNNNNNNNNNNNNNNNNNNNNNNNNNNNNNNNNNNNNNNNNNNNNNN NNNNNNNNNNNNN
NNNNNNNNNNNNNNNNNNNNNNNNNNNNNNNNNNNNNNNNNNNNNNNNNNNNNNNNNNNNNNNNNN $QNNNNNNNNNNN
NNNNNNNNNNNNNNNNNNNNNNNNNNNNNNNNNNNNNNNNNNNNNNNNNNNNNNNNNNNNNNNNNN NNNNNNNNNNNNN
NNNNNNNNNNNNNNNNNNNNNNNNNNNNNNNNNNNNNNNNNNNNNNNNNNNNNNNNNNNNNNNNNN $QNNNNNNNNNNN
NNNNNNNNNNNNNNNNNNNNNNNNNNNNNNNNNNNNNNNNNNNNNNNNNNNNNNNNNNNNNNNNNN NNNNNNNNNNNNN
NNNNNNNNNNNNNNNNNNNNNNNNNNNNNNNNNNNNNNNNNNNNNNNNNNNNNNNNNNNNNNNNNN $QNNNNNNNNNNN
NNNNNNNNNNNNNNNNNNNNNNNNNNNNNNNNNNNNNNNNNNNNNNNNNNNNNNNNNNNNNNNNNN NNNNNNNNNNNNN
NNNNNNNNNNNNNNNNNNNNNNNNNNNNNNNNNNNNNNNNNNNNNNNNNNNNNNNNNNNNNNNNNN $QNNNNNNNNNNN
NNNNNNNNNNNNNNNNNNNNNNNNNNNNNNNNNNNNNNNNNNNNNNNNNNNNNNNNNNNNNNNNNN NNNNNNNNNNNNN
NNNNNNNNNNNNNNNNNNNNNNNNNNNNNNNNNNNNNNNNNNNNNNNNNNNNNNNNNNNNNNNNNN $QNNNNNNNNNNN
NNNNNNNNNNNNNNNNNNNNNNNNNNNNNNNNNNNNNNNNNNNNNNNNNNNNNNNNNNNNNNNNNN NNNNNNNNNNNNN
NNNNNNNNNNNNNNNNNNNNNNNNNNNNNNNNNNNNNNNNNNNNNNNNNNNNNNNNNNNNNNNNNNXNNNNNNNNNNNNN
NNNNNNNNNNNNNNNNNNNNNNNNNNNNNNNNNNNNNNNNNNNNNNNNNNNNNNNNNNNNNNNNNNNNNNNNNNNNNNNN
message1:Boulder tiem
message2:Fliiiiing
message3:Goodbye!