message:Hello And Welcome To Test Chamber 04
message1:You will requirer portal momentum in this stage good luck
message2:Be Prepare to think with portals
message3:WEEEEEEEEEEEEEEEEEEeeeee!1 Bzzp...
Name:Test Chamber 04
NNNNNNNNNNNNNNNNNNNNNNNNNNNNNNNNNNN#########NNNNNNNNNNNNNNNNNNNNNNNN++++NNNNNNNNNNNNNNNNN
NNNNNNNNNNNNNNNNNNNNNNNNNNNNNNNNNNN#        %33     NNNNNNNNNNNNNNNN++++NNNNNNNNNNNNNNNNN
NNNNNNNNNNNNNNNNNNNNNNNNNNNNNNNNNNN#        %33     NNNNNNNNNNNNNNNN++++NNNNNNNNNNNNNNNNN
NNNNNNNNNNNNNNNNNNNNNNNNNNNNNNNNNNN#        %33     NNNNNNNNNNNNNNNN++++NNNNNNNNNNNNNNNNN
NNNNNNNNNNNNNNNNNNNNNNNNNNNNNNNNNNN#+NNINNNNN+N     NNNNNNNNNNNNNNNN++++NNNNNNNNNNNNNNNNN
NNNNNNNNNNNNNNNNNNNNNNNNNNNNNNNNNNN#++++++++++N     NNNNNNNNNNNNNNNN++++NNNNNNNNNNNNNNNNN
########################################NNNNNNN     NNNNNNNNNNNNNNNN++++NNNNNNNNNNNNNNNNN
###                +++++++++            1           NNNNNNNNNNNNNNNN++++NNNNNNNNNNNNNNNNN
###                +       +            1           NNNNNNNNNNNNNNNN++++NNNNNNNNNNNNNNNNN
###@               +       +            1           NNNNNNNNNNNNNNNN++++NNNNNNNNNNNNNNNNN
#####################     ###############           %iiiiiiiiiiiiii%QQ++NNNNNNNNNNNNNNNNN
NNNNNNNNNNNNNNNNNNNN#     #NNNNNNNNNNNNN#           %iiiiiiiiiiiiii%QQ++NNNNNNNNNNNNNNNNN
NNNNNNNNNNNNNNNNNNNN#     #NNNNNNNNNNNNN#           #NNNNNNNNNNNNNNN++++NNNNNNNNNNNNNNNNN
NNNNNNNNNNNNNNNNNNNN#     #NNNNNNNNNNNNN#           #NNNNNNNNNNNNNNN++++NNNNNNNNNNNNNNNNN
NNNNNNNNNNNNNNNNNNNN#     #NNNNNNNNNNNNN#    +#######NNNNNNNNNNNNNNN++++NNNNNNNNNNNNNNNNN
NNNNNNNNNNNNNNNNNNNN#     #NNNNNNNNNNNNN#    +     2#NNNNNNNNNNNNNNN++++NNNNNNNNNNNNNNNNN
NNNNNNNNNNNNNNNNNNNN#     #NNNNNNNNNNNNN#    +     2#NNNNNNNNNNNNNNN++++NNNNNNNNNNNNNNNNN
NNNNNNNNNNNNNNNNNNNN#     #NNNNNNNNNNNNN#######22222#NNNNNNNNNNNNNNN++++NNNNNNNNNNNNNNNNN
NNNNNNNNNNNNNNNNNNNN#     #NNNNNNNNNN+++++++++#    2#NNNNNNNNNNNNNNN++++NNNNNNNNNNNNNNNNN
NNNNNNNNNNNNNNNNNNNN#     #NNNNNNNNNN+NNNNNNNN#    2#NNNNNNNNNNNNNNN++++NNNNNNNNNNNNNNNNN
NNNNNNNNNNNNNNNNNNNN#     #NNNNNNNNNN+NN# N&NN#    2#NNNNNNNNNNNNNNN++++NNNNNNNNNNNNNNNNN
NNNNNNNNNNNNNNNNNNNN#     #NNNNNNNNNN+NN# N=NN#    2#NNNNNNNNNNNNNNN++++NNNNNNNNNNNNNNNNN
NNNNNNNNNNNNNNNNNNNN#     #NNNNNNNNNN+NN# hhhN#    2#NNNNNNNNNNNNNNN++++NNNNNNNNNNNNNNNNN
NNNNNNNNNNNNNNNNNNNN#     #NNNNNNNNNN+NN#    N#    2#NNNNNNNNNNNNNNN++++NNNNNNNNNNNNNNNNN
NNNNNNNNNNNNNNNNNNNN#     #NNNNNNNNNN+NN#    N#    2###NNNNNNNNNNNNN++++NNNNNNNNNNNNNNNNN
NNNNNNNNNNNNNNNNNNNN#     #NNNNNNNNNN+NN#    N#    2++#NNNNNNNNNNNNN++++NNNNNNNNNNNNNNNNN
NNNNNNNNNNNNNNNNNNNN#######NNNNNNNNNN+NN##   ##H###(#+#NNNNNNNNNNNNN+NN+NNNNNNNNNNNNNNNNN
NNNNNNNNNNNNNNNNNNNNNNNNNNNNNNNNNNNNN+NNNN   +++++++++NNNNNNNNNNNNNN+NN+NNNNNNNNNNNNNNNNN
NNNNNNNNNNNNNNNNNNNNNNNNNNNNNNNNNNNNN+NNNN   NNNNNNNNNNNNNNNNNNNNNNN+N+NNNNNNNNNNNNNNNNNN
NNNNNNNNNNNNNNNNNNNNNNNNNNNNNNNNNNNNN+NNNN   NNNNNNNNNNNNNNNNNNNNNNN+N++NNNNNNNNNNNNNNNNN
NNNNNNNNNNNNNNNNNNNNNNNNNNNNNNNNNNNNN+NNNN   NNNNNNNNNNNNNNNNNNNNNNN++N+NNNNNNNNNNNNNNNNN
NNNNNNNNNNNNNNNNNNNNNNNNNNNNNNNNNNNNN+NNNN###NNNNNNNNNNNNNNNNNNNNNNN+++NNNNNNNNNNNNNNNNNN
NNNNNNNNNNNNNNNNNNNNNNNNNNNNNNNNNNNNN+NNNNNNNNNNNNNNNNNNNNNNNNNNNNNNNN+NNNNNNNNNNNNNNNNNN
NNNNNNNNNNNNNNNNNNNNNNNNNNNNNNNNNNNNN+NNNNNNNNNNNNNNNNNNNNNNNNNNNNNNNN+NNNNNNNNNNNNNNNNNN
NNNNNNNNNNNNNNNNNNNNNNNNNNNNNNNNNNNNN+NNNNNNNNNNNNNNNNNNNNNNNNNNNNNN++NNNNNNNNNNNNNNNNNNN
NNNNNNNNNNNNNNNNNNNNNNNNNNNNNNNNNNNNN+NNNNNNNNNNNNNNNNNNNNNNNNNNNNNNNNNNNNNNNNNNNNNNNNNNN
NNNNNNNNNNNNNNNNNNNNNNNNNNNNNNNNNNNNN+NNNNNNNNNNNNNNNNNNNNNNNNNNNNNNNNNNNNNNNNNNNNNNNNNNN
NNNNNNNNNNNNNNNNNNNNNNNNNNNNNNNNNNNNN+NNNNNNNNNNNNNNNNNNNNNNNNNNNNNNNNNNNNNNNNNNNNNNNNNNN
NNNNNNNNNNNNNNNNNNNNNNNNNNNNNNNNNNNNN+NNNNNNNNNNNNNNNNNNNNNNNNNNNNNNNNNNNNNNNNNNNNNNNNNNN
NNNNNNNNNNNNNNNNNNNNNNNNNNNNNNNNNNNNN+NNNNNNNNNNNNNNNNNNNNNNNNNNNNNNNNNNNNNNNNNNNNNNNNNNN
NNNNNNNNNNNNNNNNNNNNNNNNNNNNNNNNNNNNN+NNNNNNNNNNNNNNNNNNNNNNNNNNNNNNNNNNNNNNNNNNNNNNNNNNN
NNNNNNNNNNNNNNNNNNNNNNNNNNNNNNNNNNNNN+NNNNNNNNNNNNNNNNNNNNNNNNNNNNNNNNNNNNNNNNNNNNNNNNNNN
NNNNNNNNNNNNNNNNNNNNNNNNNNNNNNNNNNNNN+NNNNNNNNNNNNNNNNNNNNNNNNNNNNNNNNNNNNNNNNNNNNNNNNNNN
