message:am i out of this facility... ouch and why this flora is all the way on my path
message1:Eh Lady over here! Oh hello there! Thank God! Finally you arrived hop over here
Name:1000 Thousand Years Pass??
NNN+NNNNNNNN+NNNNNNNNNNNNNNNNNNNNNNNNNNNNNN#%           #NNNNNNNNNNNNNNNNNNNNNNNNNNNNNNNN
NNN+NNNNNNNN+NNNNNNNNNNNNNNNNNNNNNNNNNNNNNN#%           ##NNNNNNNNNNNNNNNNNNNNNNNNNNNNNNN
NNN+NNNNNNNN+NNNNNNNNN++++++++++++++++++NNN#%           ##NNNNNNNNNNNNNNNNNNNNNNNNNNNNNNN
NNN+NNNNNNNN+NNNNNNNN++++++++++++++++++++++#%           #NNNNNNNNNNNNNNNNNNNNNNNNNNNNNNNN
NNN+NNNNNNNN+NNNNNNN++NNN+++++++++++++++++++%           #NNNNNNNNNNNNNNNNNNNNNNNNNNNNNNNN
NN++NNNNNNNN+NNNNN+++NNNNNNNNNNNNNNNN+++++++%++         #NNNNNNNNNNNNNNNNNNNNNNNNNNNNNNNN
NN++NNNNNNNN++++++++++NNNNNNNNNNNNNNN+NNN+++%++         #NNNNNNNNNNNNNNNNNNNNNNNNNNNNNNNN
NNN+NNNNNNNN+NN++NNNN++++++++++NNNNN++NNNN++%+++        #NNNNNNNNNNNNNNNNNNNNNNNNNNNNNNNN
NNN+NNNNNNNN+NNN+NNNN++NNNNNN+++++++++NNNNN#%++++       #NNNNNNNNNNNNNNNNNNNNNNNNNNNNNNNN
NNN++++++++++NNN+NN###++#############+######%+++++      #NNNNNNNNNNNNNNNNNNNNNNNNNNNNNNNN
NN++NNNN++N++NNN+NN###+++##+++#######+######%$###$      #NNNNNNNNNNNNNNNNNNNNNNNNNNNNNNNN
NN+NNNNNN+NNNNNN+NN####++#++&++######+######%$#%#$      #NNNNNNNNNNNNNNNNNNNNNNNNNNNNNNNN
NN++NNNNN++NNNNN+NN#      + = +1111111   QQQ%$###$      #NNNNNNNNNNNNNNNNNNNNNNNNNNNNNNNN
NNN+NNNNNN+NNNNN+NN#      +   +1111111   QQQ%           #NNNNNNNNNNNNNNNNNNNNNNNNNNNNNNNN
NNN+NNNNNN+NNNNN+NN#      +   +1111111   QQQ%    ########NNNNNNNNNNNNNNNNNNNNNNNNNNNNNNNN
NNN+NNNNNN++NNNNNNN#      +   +1111111   QQQ%    #NNNNNNNNNNNNNNNNNN##NNNNNNNNNNNNNNNNNNN
NNN+NNNNNNN+NNNNNNN#      +   +1111111   QQQ%    #N###N#&&&#N###NNN####NNNNNNNNNNNNNNNNNN
###+#######+########    +++   +1111111   QQQ%    #N#&&N##&##N#&##NN#&&#NNNNNNNNNNNNNNNNNN
                       ++##"""##111111   QQQ%    #N##&N####NN#&&##NN&&#NNNNNNNNNNNNNNNNNN
      +++++ + ++++++++ +###"""###11111   QQQ% $  #N#&&N#&##NN#&&&#NN&##NNNNNNNNNNNNNNNNNN
@    $$$++$$+++++$$$$+++###"""###$$$$$$$$QQQ%$####N###N#&&#NN#####NN&#NNNNNNNNNNNNNNNNNNN
######$$$$$$###$$$$$$##$#############$############NNNNNNNNNNNNNNNNNN&&NNNNNNNNNNNNNNNNNNN
NNNNNNNNNNNNNNNNNNNNNNNNNNNNNNNNNNNNNNNNNNNNNNNNN#NNNNNNNNNNNNNNNNNNN#NNNNNNNNNNNNNNNNNNN
NNNNNNNNNNNNNNNNNNNNNNNNNNNNNNNNNNNNNNNNNNNNNNNNNNNNNNNNNNNNNNNNNNNNNNNNNNNNNNNNNNNNNNNNN
NNNNNNNNNNNNNNNNNNNNNNNNNNNNNNNNNNNNNNNNNNNNNNNNNNNNNNNNNNNNNNNNNNNNNNNNNNNNNNNNNNNNNNNNN
NNNNNNNNNNNNNNNNNNNNNNNNNNNNNNNNNNNNNNNNNNNNNNNNNNNNNNNNNNNNNNNNNNNNNNNNNNNNNNNNNNNNNNNNN
NNNNNNNNNNNNNNNNNNNNNNNNNNNNNNNNNNNNNNNNNNNNNNNNNNNNNNNNNNNNNNNNNNNNNNNNNNNNNNNNNNNNNNNNN
NNNNNNNNNNNNNNNNNNNNNNNNNNNNNNNNNNNNNNNNNNNNNNNNNNNNNNNNNNNNNNNNNNNNNNNNNNNNNNNNNNNNNNNNN
NNNNNNNNNNNNNNNNNNNNNNNNNNNNNNNNNNNNNNNNNNNNNNNNNNNNNNNNNNNNNNNNNNNNNNNNNNNNNNNNNNNNNNNNN
NNNNNNNNNNNNNNNNNNNNNNNNNNNNNNNNNNNNNNNNNNNNNNNNNNNNNNNNNNNNNNNNNNNNNNNNNNNNNNNNNNNNNNNNN
NNNNNNNNNNNNNNNNNNNNNNNNNNNNNNNNNNNNNNNNNNNNNNNNNNNNNNNNNNNNNNNNNNNNNNNNNNNNNNNNNNNNNNNNN
NNNNNNNNNNNNNNNNNNNNNNNNNNNNNNNNNNNNNNNNNNNNNNNNNNNNNNNNNNNNNNNNNNNNNNNNNNNNNNNNNNNNNNNNN
NNNNNNNNNNNNNNNNNNNNNNNNNNNNNNNNNNNNNNNNNNNNNNNNNNNNNNNNNNNNNNNNNNNNNNNNNNNNNNNNNNNNNNNNN
NNNNNNNNNNNNNNNNNNNNNNNNNNNNNNNNNNNNNNNNNNNNNNNNNNNNNNNNNNNNNNNNNNNNNNNNNNNNNNNNNNNNNNNNN
NNNNNNNNNNNNNNNNNNNNNNNNNNNNNNNNNNNNNNNNNNNNNNNNNNNNNNNNNNNNNNNNNNNNNNNNNNNNNNNNNNNNNNNNN
NNNNNNNNNNNNNNNNNNNNNNNNNNNNNNNNNNNNNNNNNNNNNNNNNNNNNNNNNNNNNNNNNNNNNNNNNNNNNNNNNNNNNNNNN
NNNNNNNNNNNNNNNNNNNNNNNNNNNNNNNNNNNNNNNNNNNNNNNNNNNNNNNNNNNNNNNNNNNNNNNNNNNNNNNNNNNNNNNNN
NNNNNNNNNNNNNNNNNNNNNNNNNNNNNNNNNNNNNNNNNNNNNNNNNNNNNNNNNNNNNNNNNNNNNNNNNNNNNNNNNNNNNNNNN
NNNNNNNNNNNNNNNNNNNNNNNNNNNNNNNNNNNNNNNNNNNNNNNNNNNNNNNNNNNNNNNNNNNNNNNNNNNNNNNNNNNNNNNNN
NNNNNNNNNNNNNNNNNNNNNNNNNNNNNNNNNNNNNNNNNNNNNNNNNNNNNNNNNNNNNNNNNNNNNNNNNNNNNNNNNNNNNNNNN
NNNNNNNNNNNNNNNNNNNNNNNNNNNNNNNNNNNNNNNNNNNNNNNNNNNNNNNNNNNNNNNNNNNNNNNNNNNNNNNNNNNNNNNNN
NNNNNNNNNNNNNNNNNNNNNNNNNNNNNNNNNNNNNNNNNNNNNNNNNNNNNNNNNNNNNNNNNNNNNNNNNNNNNNNNNNNNNNNNN
NNNNNNNNNNNNNNNNNNNNNNNNNNNNNNNNNNNNNNNNNNNNNNNNNNNNNNNNNNNNNNNNNNNNNNNNNNNNNNNNNNNNNNNNN
