music:default
name:Patience...
message:Hope you can fall faster than a barrel.
NNNNNNNNNNNNNNNNNNNNNNNNNNNNNNNN
NNNNNNNNNNNNNN>NNNNNNNNNNNNNNNON
NNNNNNNNNNNNNN=NNNNNNNNNNNNNNN=N
NNNNNNNNNNNNNNjNNNNNNNNNNNNNN  N
NN i        &   &        h NN NN
NNENNNNNNNNNJNgNJNNNNNNNNNBNN  N
NNNNNNNNNNNNNN NNNNNNNNNNNNNNN N
NNNNNNNNNNNNNN NNNNNNNNNNNNNN  N
NNNNNNNNNNNNNN NNNNNNNNNNNNNN NN
NNNNNNNNNNNNNN NNNNNNNNNNNNNN  N
NN b        &   &        e NNN N
NNDNNNNNNNNNNNgNNNNNNNNNNNCNN  N
NNNNNNNNNNNNNN NNNNNNNNNNNNNN NN
NN@                       &#N  N
NNNNNNNNNNNNNN+NNNNNNNNNNNGNNN N
NNNNNNNNNNNNNN+                N
NNNNNNNNNNNNNN+NXNXNXNXNXNXNXNjN
NNNNNNNNNNNNNN+NNNNNNNNNNNNNNN"N
NNNNNNNNNNNNN + NNNNNNNNNNNNNNNN
NNNNNNNNNNNNNH+INNNNNNNNNNNNNNNN
NNNNNNNNNNNNNN+NNNNNNNNNNNNNNNNN
NNNNNNNNNNNN#1+c$$$$$$$$$$dQ#NNN
NNNNNNNNNNNNNN+NNNNNNNNNNNNNNNNN
NNNNNNNNNNNNNN"NNNNNNNNNNNNNNNNN
message1:It might also help if you can climb fast...