message:Don't try this at home.
NNNNNNNNNNNNNNNNNNNNNNNNNNNNNNNNNNNNNNNNNNNNNNNNNNN
N        NNNNNNNNNNNNNNNNNNNNNNNNNNNNNNNNNNNNNNNNNN
#        NNNNNNNNNNNNNNNNNNN#NNNNNN#NNNNNNNNNNNNNNN
# @      $$$$$$$$$$$$$$$$$$$   #NN$ NNNNNNNNNNNNNNN
#######ggNNNNNNNNNNNNNNNNNNNN$$NN$N NNNNNNNNNNNNNNN
NNNNNNN%%NNNN###NNNNNNNNNNNNN$N$$NN NNNNNNNNNNNNNNN
NNNNNNN  NN       NNNNNNNNNNN$N$$NN NNNNNNNNNNNNNNN
NN       N#       NNNNNNNNNNN$$NN$N NNNNNNNNNNNNNNN
NNQ      N#O      $$$$$$$$$   &#NN$ NNNNNNNNNNNNNNN
NNNNNNNNNN####$GNNNNNNNNNNN#N$NNNNN NNNNNNNNNNNNNNN
NNNNNNNNNNNNNN$NNNNNNNNNNNNNN$NNNNN $NNNNNNNNNNNNNN
N        NNNNN$NNNNNNNN         NNN N$NNNNNNNNNNNNN
#        NNNNN$NNNNNNNN         NNN NN$NNNNNNNNNNNN
#        NNNNN$NNNNNNNN         NNN NNN$NNNNNNNNNNN
#        $$$$$$$$$$$$$$O        NNN NNNN$NNNNNNNNNN
####N$NNNNNNNN$NNNNNNNNNNNNN###NNNN NNNNN$NNNNNNNNN
NNNNN$NNNNNNNN$NNNNNNNNNNNNNNNNNNNN NNNNNN$NNNNNNNN
NNNNN$NNNNNNNN$NNNNNNNNNNNNNNNNNNNN NNNNNNN$NNNNNNN
NNNNN$NNNNNNNN$NNNNNNNNNNNNNNNNNNNN%########$NNNNNN
NNNNN$NNNNNNNN$NNNNNNNNNNNNNNNNNNN#               N
NNNNN$NNNNNNNN$NNNNNNNNNNNNNNNNNNN#               N
NNNN# %%%%%%%% #NNNNNNNNNNNNNNNNNN#               #
NNNN##NNNNNNNN##NNNNNNNNNNNNNNNNNN#               #
NNNNNNNNNNNNNNNNNNNNNNNNNNNNNNNNNN#O              #
NNNNNNNNNNNNNNNNNNNNNNNNNNNNNNNNNN#################