>#              #
=#              #
g               #
Hhhhhhhh  &     #
%%%%%     =     #
    @     &     #
   +)) %#Gg((((+#
   )+ )  %(   +(#
   +(  ) (    )+#
   )+   (     +(#
   +(  ) )    )+#
   )+   )g)   +(#
   +(    ( )  )+#
   )+   (   ) +(#
 Q  ((((     )) #
#################
message:I expect tacOS