music:default3
NNNNNNNNN###NNNNNNNNNNNNNNNNNNNNNNNNNNNNNNNNNNNNNN
NNNNNN         NNNNNNNNNNNNNNNNNNNNNNNNNNNNNNNNNNN
NNNNNN         NNNNNNNNNNNNNNNNNNNNNNNNNNNNNNNNNNN
NNNNNN         NNNNNNNNNNNNNNN#####NNNNNNNNNNNNNNN
NNNNNNNNN   NNNNNNNNNNNNNNNNNN     NNNNNNNNN     N
NNNNNNNNN   NNNNNNNNNNNNNNNNNN     NNNNNNNNN     N
NNNNNNNNN   NNNNNNNNNNNNNNNNNN     NNNNNNNNN     N
NNNNNNNNN   NNNNNNNNNNNNNNNNNN                   N
NNNNNN#&c @ $                                    #
NNNNNNN))   NNNNNNNNNNNNNNNNNN         &         N
NNNNNNNNN   NNNNNNNNNNNNNNNNNN     ))))#((((     N
N     h        #NNNNNNNNNNNNNN     NNNNNNNNN     N
N     h        NNNNNNNNNNNNNNN     NNNNNNNNN     N
N  Q  h        NNNNNNNNNNNNNNN####CNNNNNNNNNC####N
NNNNNNN#######HNNNNNNNNNNNNNNNNNNNNNNNNNNNNNNNNNNN
name:by i300