music:default4
name:Simple... SIMPLE?!?!?!
message:Challenge- Have fun finishing it in under 60 seconds.
NNNNNNNNNNNNNNNNNNNNNNNNNNNNNNNNNNNNNNNNNNNNNNNNNNNNNNNNNNNNNNNNN
NNNNNNNNNNNN#NNNNNNNNNNNNNNNNNNNNNNNNNNNNNNNNNNNNNNNNNNNNNNNNNNNN
NNN#        @                               ###NNNNNNNNNNNNNNNNNN
NNNNANNN       NNNNNNNNNNNNNNNNNNNNNN          NNNNNNNNNNNNNNNNNN
NNNNNNNNNN     a          NN        c          NNNNNNNNNNNNNNNNNN
NNNNNNNNNNN    NNNNNNNNNNBNNDNNNNNNNN          d1   QNNNNNNNNNNNN
NNNNNNNNNNNN                                   NNNNNNNNNNNNNNNNNN
NNNNNNNNNNNN                                   NNNNNNNNNNNNNNNNNN
NNNNNNNNNNNN                                   b   NNNNNNNNNNNNNN
NNNNNNNNNNNN#NNNNNNNNNNNNNNNNNNNNNNNNNNNNNNNNN#NNNCNNNNNNNNNNNNNN
NNNNNNNNNNNNNNNNNNNNNNNNNNNNNNNNNNNNNNNNNNNNNNNNNNNNNNNNNNNNNNNNN
message1:Congrats, you beat it!