music:default
message:Hello, and welcome to Test Chamber 00.
message1:The goal of the testing is to see how portal technology is useful in real-world situations.  It is dangerous, so please be careful.
message2:Delivering cube...
message3:Fling yourself upward now.
NNNNNNNNNNNNNNNNNNNNNNNNNNNNNNNNNNNNNNNNN NNNNNNNNNNNNNNNNNNNNNNNN
N>                    NNNNNNNNNNNNNNNNNNN NNNNNNNNNNNNNNNNmN1NiN2N
NNNNNNNNNNNNNNNNNNNNNANNNNNNNNNNNNNNNNNNN NNNNNNNNNNNNNNNNLNMNJNIN
N>   l                                  N NNNNNNNNNNNNNNNNNNNNNNNN
NNNNNNNNNNNNNNNNNNNNNNNNNNNNNNNNNNNNNNN N N
NNNNNNNN                                N N
NNNNNNNNBNNNNNNNNNNNNNNNNNNNNNNNNNNNNNNNN N
NNNNNNNNNNNNNNNNNNNNNNNNNNNNNNNNNNNNNNNNN N
NNNNNNNNNNNNNNNNNNNNNNNNNNNNNNNNNNNNNNNNN N
NNNNNNNNNNNNNNNNNNNNNNNNNNNNNNNNNNNNNNNNN N
NNNNNNNNNNNNNNNNNNNNNNNNNNNNNNNNNNNNNNNNN N
NNNNNNNNNNNNNNNNNNNNNNNNNNNNNNNNNNNNNNNNN N
NNNNNNNNNNNNNNNNNNNNNNNNNNNNNNNNNNNNNNNNN N
NNNNNNNNNNNNNNNNNNNNNNNNNNNNNNNNNNNNNNNNN N
NNNNNNNNNNNNNNNNNNNNNNNNNNNNNNNNNNNNNNNNN N
NNNNNNNNNNNNNNNNNNNNNNNNNNNNNNNNNNNNNNNNN N
NNNNNNNNNNNNNNNNNNNNNNNNNNNNNNNNNNNNNNNNN N
NNNNNNNNNNNNNNNNNNNNNNNNNNNNNNNNNNNNNNNNN N
NNNNNNNNNNNNNNNNNNNNNNNNNNNNNNNNNNNNNNNNN N
NNNNNNNNNNNNNNNNNNNNNNNNNNNNNNNNNNNNNNNNN N
NNNNNNNNNNNNNNNNNNNNNNNNNNNNNNNNNNNNNNNNN N
NNNNNNNNNNNNNNNNNNNNNNNNNNNNNNNNNNNNNNNNN N
NNNNNNNNNNNNNNNNNNNNNNNNNNNNNNNNNNNNNNNNN N
NNNNNNNNNNNNNNNNNNNNNNNNNNNNNNNNNNNNNNNNN NNNNNNNNNNNNNNNNNNNNNNNNNNNNNNNNNNNNNNNNNNNNNNNNNNNNNNNNNNNNNNNNNNNNNNNNNNNNNNNNNNNNNNNN
NNNNNNNNNNNNNNNNNNNNNNNNNNNNNNNNNNNNNNNNN NNNNNNNNNNNNNNNNNNNNNNNNNNNNNNNNNNNNNNNNNNNNNNNNNNNNNNNNNNNNNNNNNNNNN#            NNNNNN
NNNNNNNNNNNNNNNNNNNNNNNNNNNNNNNNNNNNNNNNN NNNNNNNNNNNNNNNNNNNNNNNNNNNNNNNNNNNNNNNNNNNNNNNNNNNNNNNNNNNNNNNNNNNNN#            NNNNNN
NNNNNNNNNNNNNNNNNNNNNNNNNNNNNNNNNNNNNNNNN NNNNNNNNNNNNNNNNNNNNNNNNNNNNNNNNNNNNNNNNNNNNNNNNNNNNNNNNNNNNNNNNNNNNN#            N     
NNNNNNNNNNNNNNNNNNNNNNNNNNNNNNNNNNNNNNNNN NNNNNNNNNNNNNNNNNNNNNNNNNNNNNNNNNNNNNNNNNNNNNNNNNNNNNNNNNNNNNNNNNNNNNNNNNHN    NNNN     
NNNNNNNNNNNNNNNNNNNNNNNNNNNNNNNNNNNNNNNNN NNNNNNNNNNNNNNNNNNNNNNNNNNNNNNNNNNNNNNNNNNNNNNNNNNNNNNNNNNNNNNNNNNNNNNNNNN    NNNNN    N
NNNNNNNNNNNNNNNNNNNNNNNNNNNNNNNNNNNNNNNNN NNNNNNNNNNNNNNNNNNNNNNNNNNNNNNNNNNNNNNNNNNNNNNNNNNNNNNNNNNNNNNNNNNNNNNNNN    NNNNNN    N
NNNNNNNNNNNNNNNNNNNNNNNNNNNNNNNNNNNNNNNNN NNNNNNNNNNNNNNNNNNNNNNNNNNNNNNNNNNNNNNNNNNNNNNNNNNNN#                       NNNNNNN    N
NNNNNNNNNNNNNNNNNNNNNNNNNNNNNNNNNNNNNNNNN NNNNNNNNNNNNNNNNNNNNNNNNNNNNNNNNNNNNNNNNNNNNNNNNNNNN#                      NNNNNNNN    N
NNNNNNNNNNNNNNNNNNNNNNNNNNNNNNNNNNNNNNNNN NNNNNNNNNNNNNNNNNNNNNNNNNNNNNNNNNNNNNNNNNNNNNNNNNNNN#      ####    NNNN####NNNNNNNN    N
NNNNN###NNN###NNNNNNNNNNNNNNNNNNNNNNNNNNN&NNNNNNNNNNNNNNNNNNNNNNNNNNNNNNNNNNNNNNNNNNNNNNNNNNNN#      NNNN    NNNNNNNNNNNNN###    N
NNNN##N##N##N##NNNNNNNNNNNNNNNNNNNNNNNNNN NNNNNNNNNNNNNNN                 %                %         NNNN    NNNNNNNNNN          N
NNNN##N##N##N##NNNNNNNNNNNNNNNNNNNNNNNNNN NNNNNNNNNNNNNNN                 %             Q  %        &NNNN    NNNNNNNNN           N
NNNN##N##N##N##NNNNNNNNNNNNNNNNNNNNNNNNNN NNNNNNNNNNNNNNN    NNNNNNNNNNNNNNNNNNNNNNNNNNNNNNNNN#######NNNN    NNNNNNNN    N#######N
NNNNN###NNN###NNNNNNNNNNNNNNNNNNNNNNNNNNN NNNNNNNNNNNNNNN    NNNNNNNNNNNNNNNNNNNNNNNNNNNNNNNNNNNNNNNNNNNN    NNNNNNN    NNNNNNNNNN
NNNNNNNNNNNNNNNNNNNNNNNNNNNNNNNNNNNNNNNNN NNNNNNNNNNNNNNN    NNNNNNNNNNNNNNNNNNNNNNNNNNNN###NNN##NNNNNNNN    NNNNNN    NNNNNNNNNNN
NNNNNNNNNNNNNNNNNNNNNNNNNNNNN###########N N#####NNNNN####    #NNNNNNNNNNNNNNNNNNNNNNNNNN##N##N###NNNNNNNN    NNNNN    NNNNNNNNNNNN
N         1    NNNNNNNNNNNNNN#     2    N N    #NNNNN#       #NNNNNNNNNNNNNNNNNNNNNNNNNN##N##NN##NNNNNNNN    NNNN    NNNNNNNNNNNNN
Naaaa     1    NNNNNN#########NNKN 2    NjN    #######       #NNNNNNNNNNNNNNNNNNNNNNNNNN##N##NN##NNNNNNNN    NNN    NNNNNNNNNNNNNN
NN@ )     1    b                   2           k     3       #NNNNNNNNNNNNNNNNNNNNNNNNNNN###NN####NNNNNNN    h     NNNNNNNNNNNNNNN
NN))N     1    b                   2           k     3       #NNNNNNNNNNNNNNNNNNNNNNNNNNNNNNNNNNNNNNNNNNN    h    NNNNNNNNNNNNNNNN
NNNNNNNNNNNNNNNNNNNNN#########################################NNNNNNNNNNNNNNNNNNNNNNNNNNNNNNNNNNNNNNNNNNN####NNNNNNNNNNNNNNNNNNNNN
name:Welcome, test subject 3927-32E.
